181_st_interceptor.dds	unused?
allegiance.dds	unused?
arc-170.dds	mod
arc-170_normal.dds	mod
arc170r.dds	mod
armored_freerunner_01.dds	mod
armored_freerunner_01_normal.dds	mod
armored_freerunner_02.dds	mod
armored_freerunner_02_normal.dds	mod
armored_freerunner_blaster_turret.dds	mod
armored_freerunner_blaster_turret_normal.dds	mod
armored_freerunner_laser_turret.dds	mod
armored_freerunner_laser_turret_normal.dds	mod
arrow-23_landspeeder.dds	mod
arrow-23_landspeeder_normal.dds	mod
arrow-23_landspeeder_turret.dds	mod
arrow-23_landspeeder_turret_normal.dds	mod
assault_frigate.dds	unused?
assault_gunboat.dds	unused?
atst_01_diffuse.dds	mod
atst_01_normal.dds	mod
atst_02_diffuse.dds	mod
atst_02_normal.dds	mod
atst_03_diffuse.dds	mod
atst_03_normal.dds	mod
atst_04_diffuse.dds	mod
aurebesh_s.dds	mod
aurebesh_t.dds	mod
b-wing_00.dds	mod
b-wing_00_normal.dds	mod
b-wing_01.dds	mod
b-wing_01_normal.dds	mod
b-wing_02.dds	mod
b-wing_02_normal.dds	mod
b-wing_03.dds	mod
b-wing_03_normal.dds	mod
b-wing_04.dds	mod
b-wing_04_normal.dds	mod
b-wing_05.dds	mod
b-wing_05_normal.dds	mod
b-wing_06.dds	mod
b-wing_06_normal.dds	mod
b-wing_07.dds	mod
b-wing_07_normal.dds	mod
b-wing_08.dds	mod
b-wing_08_normal.dds	mod
b-wing_09.dds	mod
b-wing_09_normal.dds	mod
b-wing_10.dds	mod
b-wing_10_normal.dds	mod
b-wing_11.dds	mod
b-wing_11_normal.dds	mod
b-wing_12.dds	mod
b-wing_12_normal.dds	mod
b-wing_13.dds	mod
b-wing_13_normal.dds	mod
b-wing_14.dds	mod
b-wing_14_normal.dds	mod
b-wing_15.dds	mod
b-wing_15_normal.dds	mod
b-wing_16.dds	mod
b-wing_16_normal.dds	mod
b-wing_17.dds	mod
b-wing_17_normal.dds	mod
b-wing_18.dds	mod
b-wing_18_normal.dds	mod
b-wing_19.dds	mod
b-wing_19_normal.dds	mod
b-wing_20.dds	mod
b-wing_20_normal.dds	mod
b-wing_21.dds	mod
b-wing_21_normal.dds	mod
b-wing_22.dds	mod
b-wing_22_normal.dds	mod
b-wing_23.dds	mod
b-wing_23_normal.dds	mod
b-wing_24.dds	mod
b-wing_24_normal.dds	mod
b-wing_25.dds	mod
b-wing_25_normal.dds	mod
b-wing_26.dds	mod
b-wing_26_normal.dds	mod
b-wing_27.dds	mod
b-wing_27_normal.dds	mod
b-wing_28.dds	mod
b-wing_28_normal.dds	mod
b-wing_29.dds	mod
b-wing_29_normal.dds	mod
b-wing_30.dds	mod
b-wing_30_normal.dds	mod
b-wing_31.dds	mod
b-wing_31_normal.dds	mod
b-wing_32.dds	mod
b-wing_32_normal.dds	mod
b-wing_33.dds	mod
b-wing_33_normal.dds	mod
b-wing_34.dds	mod
b-wing_34_normal.dds	mod
b-wing_35.dds	mod
b-wing_35_normal.dds	mod
b-wing_36.dds	mod
b-wing_36_normal.dds	mod
b-wing_37.dds	mod
b-wing_37_normal.dds	mod
b-wing_38.dds	mod
b-wing_38_normal.dds	mod
b-wing_39.dds	mod
b-wing_39_normal.dds	mod
b-wing_40.dds	mod
b-wing_40_normal.dds	mod
b-wing_41.dds	mod
b-wing_41_normal.dds	mod
b-wing_42.dds	mod
blueflash.dds	unused?
bluethruster.dds	unused?
bluethruster_b.dds	unused?
blue_diver.dds	unused?
blue_diver_b.dds	unused?
blue_diver_l.dds	unused?
bothanassaultcruiser.dds	unused?
briar_pistol.dds	unused?
btl_k-wing.dds	mod
btl_k-wing_normal.dds	mod
cc-7700efrigate.dds	mod
cc-7700_frigate.dds	mod
cc-7700_frigate_normal.dds	mod
cis_aat.dds	unused?
cis_aat_bm.dds	unused?
cis_crabdroid.dds	unused?
cis_crabdroid_b.dds	unused?
cis_droid_gunship_bump.dds	unused?
cis_droid_gunship_diff.dds	unused?
cis_homing_droid_bump.dds	unused?
cis_homing_droid_diff.dds	unused?
cis_mtt_bluestripes.dds	unused?
cis_snailtank_eyes.dds	unused?
cis_snail_tank_parts.dds	unused?
cis_snail_tank_parts2.dds	unused?
cis_snail_tank_parts2_n.dds	unused?
cis_snail_tank_parts_n.dds	unused?
cis_snail_tank_tread.dds	unused?
cis_snail_tank_tread2.dds	unused?
cis_snail_tank_tread2_n.dds	unused?
cis_snail_tank_tread_n.dds	unused?
cis_tank_fighter_1.dds	unused?
cis_tank_fighter_1_b.dds	unused?
cis_tank_fighter_2.dds	unused?
cis_tank_fighter_2_b.dds	unused?
cis_tank_fighter_3.dds	unused?
cis_tank_fighter_3_b.dds	unused?
cis_tank_fighter_4.dds	unused?
cis_tank_fighter_4_b.dds	unused?
clonehands.dds	unused?
clonehands_n.dds	unused?
clonetorso_dirty.dds	unused?
clonetorso_dirty_n.dds	unused?
conqueror_star_destroyer.dds	unused?
conqueror_star_destroyer_bridge.dds	unused?
conqueror_star_destroyer_bridge_normal.dds	unused?
conqueror_star_destroyer_normal.dds	unused?
corellian_bb.dds	unused?
corellian_gunship.dds	unused?
cv_invisible_hand.dds	unused?
cv_lucrehulk.dds	unused?
cv_lucrehulk_b.dds	unused?
cv_lucrehulk_e.dds	unused?
cv_lucrehulk_l.dds	unused?
cv_lucrehulk_p.dds	unused?
cv_lucrehulk_p_b.dds	unused?
cv_munificent.dds	unused?
cv_munificent_b.dds	unused?
cv_munificent_rebel.dds	unused?
cv_munificent_tonith.dds	unused?
cv_providence.dds	unused?
cv_providence_b.dds	unused?
cv_recusant.dds	unused?
cv_recusant_b.dds	unused?
cv_recusant_rebel.dds	unused?
dauntless.dds	unused?
defiance-class_mc90_star_cruiser_thruster_off.dds	mod
defiance-class_mc90_star_cruiser_thruster_off_normal.dds	mod
defiance-class_mc90_star_cruiser_thruster_on.dds	mod
diamoncruiser.dds	unused?
diamoncruiser_b.dds	unused?
dominator-class_star_destroyer.dds	mod
dominator-class_star_destroyer_normal.dds	mod
dreadnaught.dds	unused?
dreadnaught_b.dds	unused?
e-wing.dds	mod
e-wing_normal.dds	mod
eb_basewall.dds	unused?
eb_basewall_alt1.dds	unused?
eb_basewall_ds1.dds	unused?
eb_basewall_ds2.dds	unused?
eb_basewall_ds3.dds	unused?
eb_icc.dds	unused?
eb_icc_d1.dds	unused?
eb_icc_d2.dds	unused?
eb_icc_d3.dds	unused?
eb_infantrybarracks.dds	unused?
eb_infantrybarracks_d1.dds	unused?
eb_infantrybarracks_d2.dds	unused?
eb_infantrybarracks_d3.dds	unused?
eb_lightfactory.dds	unused?
eb_lightfactory_d1.dds	unused?
eb_lightfactory_d2.dds	unused?
eb_lightfactory_d3.dds	unused?
eb_magnepulsecannon.dds	unused?
eb_magnepulsecannon_d1.dds	unused?
eb_magnepulsecannon_d2.dds	unused?
eb_magnepulsecannon_d3.dds	unused?
eb_megaadvancedweapons.dds	unused?
eb_megaadvancedweapons_d1.dds	unused?
eb_megaadvancedweapons_d2.dds	unused?
eb_megaadvancedweapons_d3.dds	unused?
eb_officeracademy.dds	unused?
eb_officeracademy_d1.dds	unused?
eb_officeracademy_d2.dds	unused?
eb_officeracademy_d3.dds	unused?
eb_researchfacility.dds	unused?
eb_researchfacility_d1.dds	unused?
eb_researchfacility_d2.dds	unused?
eb_researchfacility_d3.dds	unused?
eb_tltower.dds	unused?
eb_tltower_d1.dds	unused?
eb_tltower_d2.dds	unused?
eb_tltower_d3.dds	unused?
eb_uplink_station_abandon.dds	unused?
eb_uplink_station_abandon_alt1.dds	unused?
eb_uplink_station_abandon_alt2.dds	unused?
eb_uplink_station_abandon_alt3.dds	unused?
eb_uplink_station_abandon_dish.dds	unused?
eb_vehiclefactory.dds	unused?
eb_vehiclefactory_d1.dds	unused?
eb_vehiclefactory_d2.dds	unused?
eb_vehiclefactory_d3.dds	unused?
ei_army_trooper_armor.dds	mod
ei_army_trooper_armor2.dds	mod
ei_army_trooper_armor2_b.dds	mod
ei_army_trooper_armor_b.dds	mod
ei_army_trooper_backpack.dds	mod
ei_army_trooper_backpack_b.dds	mod
ei_army_trooper_body.dds	mod
ei_army_trooper_body_b.dds	mod
ei_army_trooper_helmet.dds	mod
ei_army_trooper_helmet_b.dds	mod
ei_atstpilot.dds	unused?
ei_atstpilot_gloss.dds	unused?
ei_brakiss.dds	unused?
ei_brakiss_n.dds	unused?
ei_clone_weapons.dds	unused?
ei_darktrooper.dds	unused?
ei_darktrooper_pack.dds	unused?
ei_darktroop_three.dds	unused?
ei_darktroop_two.dds	unused?
ei_elite_guard_body.dds	unused?
ei_elite_guard_helmet.dds	unused?
ei_elite_guard_legs.dds	unused?
ei_eweb.dds	unused?
ei_eweb_bc.dds	unused?
ei_gadmiral_thrawn.dds	unused?
ei_gadmiral_thrawn_bc.dds	unused?
ei_imperial2oficer.dds	unused?
ei_imperialcolonel.dds	unused?
ei_imperialgeneral.dds	unused?
ei_imperialofficer.dds	unused?
ei_imperialtrooper.dds	unused?
ei_imperial_army_trooper.dds	unused?
ei_imperial_army_trooper_gloss.dds	unused?
ei_isb_colon.dds	unused?
ei_isb_private.dds	unused?
ei_isb_sergant.dds	unused?
ei_isb_trooper.dds	unused?
ei_novatrooper_helmet.dds	unused?
ei_novatrooper_legs.dds	unused?
ei_officer_body.dds	unused?
ei_officer_body_b.dds	unused?
ei_officer_gloves.dds	unused?
ei_officer_gloves_b.dds	unused?
ei_officer_parts.dds	mod
ei_officer_parts_b.dds	mod
ei_sandprivate.dds	unused?
ei_sandsergant.dds	unused?
ei_sandtrooper.dds	unused?
ei_stormcommando.dds	unused?
ei_stormcommando_b.dds	unused?
ei_stormcommando_glov.dds	unused?
ei_stormcommando_glov_b.dds	unused?
ei_stormcommando_helm.dds	unused?
ei_stormcommando_helm_b.dds	unused?
ei_stormtrooper.dds	unused?
ei_stormtrooper_b.dds	unused?
ei_stormtrooper_glov.dds	unused?
ei_stormtrooper_glov_b.dds	unused?
ei_stormtrooper_helm.dds	unused?
ei_stormtrooper_helm_b.dds	unused?
ei_stormtrooper_pauldron.dds	unused?
enforcership.dds	unused?
enforcership_b.dds	unused?
engine_glow_blue_dist.tga	mod
engine_glow_blue_wave.tga	mod
engine_glow_fancy_blue.tga	mod
engine_glow_fancy_white.tga	unused?
escort_carrier.dds	unused?
ev_13x.dds	unused?
ev_13x_bridge.dds	unused?
ev_2mtank.dds	unused?
ev_a9_floating_fortress.dds	unused?
ev_a9_floating_fortress_b.dds	unused?
ev_assertor_ssd1.dds	unused?
ev_assertor_ssd1_b.dds	unused?
ev_assertor_ssd2.dds	unused?
ev_assertor_ssd2_b.dds	unused?
ev_assertor_ssd3.dds	unused?
ev_assertor_ssd3_b.dds	unused?
ev_at-aa.dds	unused?
ev_at-barge.dds	unused?
ev_at-st-as.dds	unused?
ev_at-st-as_bc.dds	unused?
ev_atdp.dds	unused?
ev_atdp_n.dds	unused?
ev_atpt cilind_b.dds	unused?
ev_atpt_body1.dds	unused?
ev_atpt_body1_b.dds	unused?
ev_atpt_cilind.dds	unused?
ev_atpt_cockpit.dds	unused?
ev_atpt_cockpit_b.dds	unused?
ev_atpt_extras.dds	unused?
ev_atpt_extras_b.dds	unused?
ev_atpt_foot.dds	unused?
ev_atpt_foot_b.dds	unused?
ev_atpt_head.dds	unused?
ev_atpt_head_b.dds	unused?
ev_atpt_legs.dds	unused?
ev_atpt_legs2.dds	unused?
ev_atpt_legs2_b.dds	unused?
ev_atpt_legs_b.dds	unused?
ev_atpt_subhead.dds	unused?
ev_atpt_subhead_b.dds	unused?
ev_bellator.dds	unused?
ev_bellator_b.dds	unused?
ev_imperialcraft.dds	unused?
ev_juggernaut.dds	mod
ev_juggernaut_wheel.dds	mod
ev_knight_hammer_a.dds	unused?
ev_knight_hammer_b.dds	unused?
ev_knight_hammer_b_bump.dds	unused?
ev_knight_hammer_c.dds	unused?
ev_laat.dds	unused?
ev_laat_bc.dds	unused?
ev_lambdashuttle.dds	unused?
ev_maat.dds	unused?
ev_maat_b.dds	unused?
ev_mdu.dds	unused?
ev_mobile_artillery.dds	unused?
ev_mobile_artillery_b.dds	unused?
ev_predatolightsrr24.dds	unused?
ev_predatolightsrr25.dds	unused?
ev_predatolightsrr27.dds	unused?
ev_predatolightsrr28.dds	unused?
ev_predatorhull.dds	unused?
ev_predatorlightshull.dds	unused?
ev_predatorr24.dds	unused?
ev_predatorr25.dds	unused?
ev_predatorr27.dds	unused?
ev_predatorr28.dds	unused?
ev_s1_firehawke.dds	unused?
ev_s1_firehawke_bump.dds	unused?
ev_scanlines5.dds	unused?
ev_sd_thruster.dds	unused?
ev_secutor.dds	unused?
ev_secutor_b.dds	unused?
ev_sentinel.dds	mod
ev_sentinel_l.dds	mod
ev_sentinel_n.dds	mod
ev_spmat.dds	unused?
ev_spmat_d1.dds	unused?
ev_tie01.dds	unused?
ev_tieadvanced.dds	unused?
ev_tieavenger.dds	unused?
ev_tieavenger_gloss.dds	unused?
ev_tiebomber.dds	unused?
ev_tiecrawler.dds	unused?
ev_tiecrawlertreads.dds	mod
ev_tiehunter.dds	unused?
ev_tiehunter_gloss.dds	unused?
ev_tiescout.dds	unused?
ev_tietank.dds	unused?
ev_tietank_n.dds	unused?
ev_tie_defender.dds	unused?
ev_tie_interceptor.dds	unused?
ev_tie_in_panels.dds	unused?
ev_tie_in_panels_b.dds	unused?
ev_tie_in_wings.dds	unused?
ev_tie_in_wings_b.dds	unused?
ev_tie_lancet.dds	unused?
ev_tie_ln_body.dds	unused?
ev_tie_ln_body_b.dds	unused?
ev_tie_ln_panels.dds	unused?
ev_tie_ln_panels_b.dds	unused?
ev_tie_ln_wings.dds	unused?
ev_tie_ln_wings_b.dds	unused?
ev_tie_phantom.dds	unused?
ev_tie_window.dds	unused?
ev_victory.dds	unused?
ev_victory_bridge.dds	unused?
ev_victory_bridge_bump.dds	unused?
ev_victory_bump.dds	unused?
ev_warhammerr22-25.dds	unused?
ev_warhammerr22-25lights.dds	unused?
ev_warhammerr26.dds	unused?
ev_warhammerr26lights.dds	unused?
ev_warhammerr27.dds	unused?
ev_warhammerr27lights.dds	unused?
ev_warhammerr28.dds	unused?
ev_warhammerr28lights.dds	unused?
ev_warhammerr29-30.dds	unused?
ev_warhammerr29-30lights.dds	unused?
ev_warhammerr31-32.dds	unused?
ev_warhammerr31-32lights.dds	unused?
ev_warhammerr34.dds	unused?
ev_warhammerr39.dds	unused?
ev_warhammerr39lights.dds	unused?
ew_rt_97c.dds	unused?
ew_rt_97c_b.dds	unused?
executor-class_star_dreadnought_thruster_off.dds	mod
executor-class_star_dreadnought_thruster_off_normal.dds	mod
executor-class_star_dreadnought_thruster_on.dds	mod
exexplo03.dds	unused?
exexplo03n.dds	unused?
exexplo03nb.dds	unused?
exshckwave.dds	unused?
ferret.dds	unused?
galaxy_destroyer.dds	unused?
galaxy_destroyer_b.dds	unused?
galaxy_destroyer_l.dds	unused?
hammerhead_crashed.dds	unused?
hammerhead_crashed_b.dds	unused?
hangar.tga	unused?
head_eli.dds	unused?
head_eli_b.dds	unused?
head_romodi.dds	unused?
head_romodi_b.dds	unused?
head_viktor.dds	mod
head_viktor_b.dds	mod
heavygunship.dds	unused?
heavy_tracker_00.dds	mod
heavy_tracker_00_normal.dds	mod
heavy_tracker_01.dds	mod
heavy_tracker_01_normal.dds	mod
heavy_tracker_02.dds	mod
heavy_tracker_02_normal.dds	mod
heavy_tracker_turret.dds	mod
heavy_tracker_turret_normal.dds	mod
homeone.dds	unused?
imperial-class_star_destroyer.dds	mod
imperial-class_star_destroyer_bridge.dds	mod
imperial-class_star_destroyer_bridge_normal.dds	mod
imperial-class_star_destroyer_hull.dds	unused?
imperial-class_star_destroyer_hull_normal.dds	unused?
imperial-class_star_destroyer_lit_hull.dds	unused?
imperial-class_star_destroyer_lit_hull_normal.dds	unused?
imperial-class_star_destroyer_normal.dds	mod
imperial-class_star_destroyer_thruster_off.dds	mod
imperial-class_star_destroyer_thruster_off_normal.dds	mod
imperial-class_star_destroyer_thruster_on.dds	mod
imperial_ii-class_star_destroyer.dds	mod
imperial_ii-class_star_destroyer_black.dds	mod
imperial_ii-class_star_destroyer_black_normal.dds	mod
imperial_ii-class_star_destroyer_bridge.dds	mod
imperial_ii-class_star_destroyer_bridge_black.dds	mod
imperial_ii-class_star_destroyer_bridge_black_normal.dds	mod
imperial_ii-class_star_destroyer_bridge_normal.dds	mod
imperial_ii-class_star_destroyer_normal.dds	mod
imp_carrack_cruiser.dds	unused?
imp_eidolon.dds	unused?
imp_heavy_corvette.dds	unused?
imp_lancer_frigate.dds	unused?
imp_loronar_strike_cruiser.dds	unused?
imp_praetorbattlercruiser_c.dds	unused?
imp_praetorbattlercruiser_n.dds	unused?
i_bombardment.dds	unused?
i_circle00.dds	unused?
i_circle01.dds	unused?
i_circle02.dds	unused?
i_galactic_dashboard_skirmish.dds	unused?
i_galactic_dashboard_skirmish_rebel.dds	unused?
i_galactic_dashboard_wide.dds	unused?
i_galactic_dashboard_wide_rebel.dds	unused?
i_selection_cutout_space.dds	unused?
i_selection_g_cutout.dds	unused?
i_selection_land.dds	unused?
i_selection_land_g.dds	unused?
i_selection_space.dds	unused?
i_selection_space_g.dds	unused?
lambda-class_t-4_shuttle.dds	mod
lambda-class_t-4_shuttle_normal.dds	mod
liberator.dds	unused?
liberty-class_mc80_star_cruiser.dds	unused?
liberty-class_mc80_star_cruiser_normal.dds	unused?
light.dds	unused?
lightswhite_1.dds	unused?
loadmenuback.dds	unused?
majestic.dds	unused?
marauder-class_corvette.dds	mod
marauder-class_corvette_normal.dds	mod
mc-60.dds	unused?
mc80c.dds	unused?
mc85.dds	unused?
mc90.dds	unused?
mc_40.dds	unused?
mc_80.dds	unused?
menuback_overlay.dds	unused?
menuback_overlay_german_french.dds	unused?
missile_gunboat.dds	unused?
modular_taskforce_cruiser.dds	mod
modular_taskforce_cruiser_normal.dds	mod
mt_commandbar.tga	unused?
nb_baseshieldgen.dds	unused?
nb_baseshieldgen_d1.dds	unused?
nb_baseshieldgen_d2.dds	unused?
nb_baseshieldgen_d3.dds	unused?
nb_cm22mining_abandon.dds	unused?
nb_cm22mining_d1.dds	unused?
nb_cm22mining_d2.dds	unused?
nb_cm22mining_d3.dds	unused?
nb_cmc22mining.dds	unused?
nb_shieldripple.tga	unused?
nb_shieldwave.tga	unused?
nebula-class_star_destroyer_thruster_off.dds	mod
nebula-class_star_destroyer_thruster_off_normal.dds	mod
nebula-class_star_destroyer_thruster_on.dds	mod
nebula-class_star_destroyer_turret.dds	mod
nebula-class_star_destroyer_turret_normal.dds	mod
nebulon_b_frigate.dds	unused?
nv_consular_wreck.dds	unused?
nv_consular_wreck_b.dds	unused?
nv_gozanti_wreck.dds	unused?
nv_gozanti_wreck_b.dds	unused?
nv_space_build_center.dds	unused?
nv_space_build_center_b.dds	unused?
nv_vwing.dds	unused?
nv_vwinr.dds	unused?
orange_thruster.dds	unused?
pa_praetorhull.dds	unused?
pa_praetorhull_bc.dds	unused?
pa_praetor_accessories.dds	unused?
pa_praetor_accessories_bc.dds	unused?
planetgas0-cl.dds	unused?
px-10_compact_assault_vehicle.dds	mod
px-10_compact_assault_vehicle_normal.dds	mod
px-10_compact_assault_vehicle_treads.dds	mod
px-10_compact_assault_vehicle_treads_normal.dds	mod
p_aat_debris.dds	unused?
p_aat_debris_2.dds	unused?
p_aat_debris_2_b.dds	unused?
p_aat_debris_b.dds	unused?
p_black_hole_gravity.tga	unused?
p_fire.dds	unused?
p_fire.tga	unused?
p_particle_exp1_orig.dds	unused?
p_particle_explosion1.dds	unused?
p_particle_explosion2.dds	unused?
p_particle_explosion3.dds	unused?
p_particle_master.dds	unused?
qh-7_chariot_light_assault_vehicle_01.dds	mod
qh-7_chariot_light_assault_vehicle_01_normal.dds	mod
qh-7_chariot_light_assault_vehicle_02.dds	mod
qh-7_chariot_light_assault_vehicle_02_normal.dds	mod
r-41_starchaser.dds	mod
r-41_starchaser_normal.dds	mod
rb_acc.dds	unused?
rb_acc_d1.dds	unused?
rb_acc_d2.dds	unused?
rb_acc_d3.dds	unused?
rb_barracks.dds	unused?
rb_barracks_d1.dds	unused?
rb_barracks_d2.dds	unused?
rb_barracks_d3.dds	unused?
rb_basewall-mid.dds	unused?
rb_basewall-mid_ds1.dds	unused?
rb_basewall-mid_ds2.dds	unused?
rb_comcenter_alt1.dds	unused?
rb_comcenter_alt2.dds	unused?
rb_comcenter_alt3.dds	unused?
rb_heavyvehiclefactory.dds	unused?
rb_heavyvehiclefactory_d1.dds	unused?
rb_heavyvehiclefactory_d2.dds	unused?
rb_heavyvehiclefactory_d3.dds	unused?
rb_hypervelocitygun.dds	unused?
rb_hypervelocitygun_alt1.dds	unused?
rb_hypervelocitygun_alt2.dds	unused?
rb_hypervelocitygun_alt3.dds	unused?
rb_infantry_barracks.dds	unused?
rb_infantry_barracks_d1.dds	unused?
rb_infantry_barracks_d2.dds	unused?
rb_infantry_barracks_d3.dds	unused?
rb_ioncannon.dds	unused?
rb_ioncannon_alt1.dds	unused?
rb_ioncannon_alt2.dds	unused?
rb_ioncannon_alt3.dds	unused?
rb_lightvehiclefactory.dds	unused?
rb_lightvehiclefactory_d1.dds	unused?
rb_lightvehiclefactory_d2.dds	unused?
rb_lightvehiclefactory_d3.dds	unused?
rb_officeracademy.dds	unused?
rb_officeracademy_d1.dds	unused?
rb_officeracademy_d2.dds	unused?
rb_officeracademy_d3.dds	unused?
rb_researchfacility.dds	unused?
rb_researchfacility_d1.dds	unused?
rb_researchfacility_d2.dds	unused?
rb_researchfacility_d3.dds	unused?
rb_shield-generator.dds	unused?
rb_shield-generator_d1.dds	unused?
rb_shield-generator_d2.dds	unused?
rb_shield-generator_d3.dds	unused?
rc_sniperrifle.dds	unused?
reactor_lens_effect_shine.dds	unused?
reactor_lens_effect_shine_white.dds	unused?
reb_defender_destroye2.dds	unused?
reb_defender_destroyer.dds	unused?
reb_defender_destroyer_b.dds	unused?
redflash.dds	unused?
reef_home-class_mc80_star_cruiser.dds	mod
reef_home-class_mc80_star_cruiser_normal.dds	mod
rep_corvette01_b.dds	unused?
rep_corvette02.dds	unused?
rep_corvette_l.dds	unused?
rep_dc15rifle.dds	unused?
rep_dc15rifle_b.dds	unused?
rep_hover_fightertank.dds	unused?
rep_hover_fightertank_b.dds	unused?
rev_acclamator1.dds	unused?
rev_acclamator1_bc.dds	unused?
rev_acclamator1_lights.dds	unused?
rev_acclamator1_thruster.dds	unused?
rev_bulwark.dds	unused?
ri_corran_horn.dds	unused?
ri_corran_horn_n.dds	unused?
ri_kyle_katarn_jedi.dds	unused?
ri_newrassault_goggles.dds	unused?
ri_nrassaultinf_desert.dds	unused?
ri_nrassaultinf_forest.dds	unused?
ri_nrassaultinf_gloss.dds	unused?
ri_nrassaultinf_snow.dds	unused?
ri_nrassaultinf_urban.dds	unused?
ri_vanguard_desert.dds	unused?
ri_vanguard_desert_b.dds	unused?
ri_vanguard_jungle.dds	unused?
ri_vanguard_jungle_b.dds	unused?
ri_vanguard_urban.dds	unused?
ri_vanguard_urban_b.dds	unused?
rv_aac_hovertank bump.dds	unused?
rv_aac_hovertank.dds	unused?
rv_assaultfrigate.dds	unused?
rv_awing.dds	mod
rv_corvette.dds	unused?
rv_endurance.dds	unused?
rv_enduranceengines.dds	unused?
rv_enduranceengines_bc.dds	unused?
rv_endurance_bc.dds	unused?
rv_gallofreehtt26.dds	unused?
rv_gargantuan.dds	unused?
rv_gargantuan_damage.dds	unused?
rv_herotransport.dds	unused?
rv_kdy_endurance.dds	unused?
rv_kdy_endurance_b.dds	unused?
rv_mc30cmoncal.dds	unused?
rv_mdu.dds	unused?
rv_mediator_cruiser.dds	unused?
rv_mediator_cruiser_bump.dds	unused?
rv_mptl-2a.dds	unused?
rv_mptl-2aspotter.dds	unused?
rv_nebulachassis_bc.dds	unused?
rv_nebulachassis_tc.dds	unused?
rv_nebulaengine.dds	unused?
rv_nebulaengine_bc.dds	unused?
rv_nebulonb.tga	unused?
rv_nebulonb_bc.tga	unused?
rv_new_nebula_defender_sd.dds	unused?
rv_new_nebula_defender_sd_b.dds	unused?
rv_ranger.dds	unused?
rv_snowspeeder_dmg.dds	unused?
rv_speeder.dds	unused?
rv_starbird.dds	unused?
rv_t-1b.dds	mod
rv_t-1b_bump.dds	mod
rv_t2btank.dds	unused?
rv_t2b_c.dds	mod
rv_t2b_n.dds	mod
rv_t3-b.dds	mod
rv_t3-b_bump.dds	mod
rv_t3-b_turret.dds	mod
rv_t3-b_turret_bump.dds	mod
rv_t4btank.dds	unused?
rv_tanktreads.dds	unused?
rv_tanktreads2.dds	unused?
rv_transport.dds	unused?
rv_ulav.dds	unused?
rv_ulav_b.dds	unused?
rv_vwing.dds	unused?
rv_vwing_bc.dds	unused?
rv_ywing.dds	mod
rz_awing.dds	mod
saber_red_glow.dds	unused?
saber_silver_glow.dds	unused?
sacheen.dds	unused?
scimitar_assault_bomber_00.dds	mod
scimitar_assault_bomber_00_normal.dds	mod
scimitar_assault_bomber_01.dds	mod
scimitar_assault_bomber_01_normal.dds	mod
scimitar_assault_bomber_02.dds	mod
scimitar_assault_bomber_02_normal.dds	mod
scimitar_assault_bomber_03.dds	mod
scimitar_assault_bomber_03_normal.dds	mod
scimitar_assault_bomber_04.dds	mod
scimitar_assault_bomber_04_normal.dds	mod
scimitar_assault_bomber_05.dds	mod
scimitar_assault_bomber_05_normal.dds	mod
scimitar_assault_bomber_06.dds	mod
scimitar_assault_bomber_06_normal.dds	mod
scimitar_assault_bomber_07.dds	mod
scimitar_assault_bomber_07_normal.dds	mod
scimitar_assault_bomber_08.dds	mod
scimitar_assault_bomber_08_normal.dds	mod
scimitar_assault_bomber_09.dds	mod
scimitar_assault_bomber_09_normal.dds	mod
scimitar_assault_bomber_10.dds	mod
scimitar_assault_bomber_10_normal.dds	mod
scimitar_assault_bomber_11.dds	mod
scimitar_assault_bomber_11_normal.dds	mod
scimitar_assault_bomber_12.dds	mod
scimitar_assault_bomber_12_normal.dds	mod
scimitar_assault_bomber_13.dds	mod
scimitar_assault_bomber_13_normal.dds	mod
scimitar_assault_bomber_14.dds	mod
scimitar_assault_bomber_14_normal.dds	mod
scimitar_assault_bomber_15.dds	mod
scimitar_assault_bomber_15_normal.dds	mod
scimitar_assault_bomber_16.dds	mod
scimitar_assault_bomber_16_normal.dds	mod
scimitar_assault_bomber_17.dds	mod
scimitar_assault_bomber_17_normal.dds	mod
scimitar_assault_bomber_18.dds	mod
scimitar_assault_bomber_18_normal.dds	mod
scimitar_assault_bomber_19.dds	mod
scimitar_assault_bomber_19_normal.dds	mod
scimitar_assault_bomber_20.dds	mod
scimitar_assault_bomber_20_normal.dds	mod
scimitar_assault_bomber_21.dds	mod
scimitar_assault_bomber_21_normal.dds	mod
scimitar_assault_bomber_22.dds	mod
scimitar_assault_bomber_22_normal.dds	mod
scimitar_assault_bomber_23.dds	mod
scimitar_assault_bomber_23_normal.dds	mod
scimitar_assault_bomber_24.dds	mod
scimitar_assault_bomber_24_normal.dds	mod
scimitar_assault_bomber_25.dds	mod
scimitar_assault_bomber_25_normal.dds	mod
scimitar_assault_bomber_26.dds	mod
scimitar_assault_bomber_26_normal.dds	mod
scimitar_assault_bomber_27.dds	mod
scimitar_assault_bomber_27_normal.dds	mod
scimitar_assault_bomber_28.dds	mod
scimitar_assault_bomber_28_normal.dds	mod
scimitar_assault_bomber_29.dds	mod
scimitar_assault_bomber_29_normal.dds	mod
scimitar_assault_bomber_30.dds	mod
scimitar_assault_bomber_30_normal.dds	mod
scimitar_assault_bomber_31.dds	mod
scimitar_assault_bomber_31_normal.dds	mod
scimitar_assault_bomber_32.dds	mod
scimitar_assault_bomber_32_normal.dds	mod
scimitar_assault_bomber_33.dds	mod
scimitar_assault_bomber_33_normal.dds	mod
scimitar_assault_bomber_34.dds	mod
scimitar_assault_bomber_34_normal.dds	mod
scimitar_assault_bomber_35.dds	mod
scimitar_assault_bomber_35_normal.dds	mod
scimitar_assault_bomber_36.dds	mod
scimitar_assault_bomber_36_normal.dds	mod
scimitar_assault_bomber_37.dds	mod
scimitar_assault_bomber_37_normal.dds	mod
scimitar_assault_bomber_38.dds	mod
scimitar_assault_bomber_38_normal.dds	mod
scimitar_assault_bomber_39.dds	mod
scimitar_assault_bomber_39_normal.dds	mod
sei_battledroid.dds	unused?
sei_dooku.dds	unused?
sei_dookucape.dds	unused?
sei_dooku_face.dds	unused?
sei_dooku_head.dds	unused?
sei_e5.dds	unused?
sev_bulwark.dds	unused?
sev_bulwark_bc.dds	unused?
sev_bulwark_lights.dds	unused?
sev_bulwark_thruster.dds	unused?
sev_bulwark_thruster_bc.dds	unused?
sev_carrier.dds	unused?
sev_carrier_b.dds	unused?
sev_carrier_l.dds	unused?
sev_droid_bomber.dds	unused?
sev_vulture.dds	unused?
sev_vulture_b.dds	unused?
shield_color.tga	unused?
sovereign-class_star_dreadnought.dds	mod
sovereign-class_star_dreadnought_normal.dds	mod
splash.dds	unused?
splash_french.dds	unused?
splash_german.dds	unused?
splash_italian.dds	unused?
splash_spanish.dds	unused?
splash_uk.dds	unused?
stormtrooper_body.dds	unused?
stormtrooper_body_b.dds	unused?
stormtrooper_e11.dds	unused?
stormtrooper_e11_b.dds	unused?
stormtrooper_hands.dds	unused?
stormtrooper_hands_b.dds	unused?
stormtrooper_helmet.dds	unused?
stormtrooper_helmet_b.dds	unused?
stormtrooper_magma_backpack.dds	unused?
stormtrooper_magma_backpack_b.dds	unused?
strident.dds	unused?
strident_b.dds	unused?
strident_l.dds	unused?
super_transport_viii_escort_carrier.dds	mod
super_transport_viii_escort_carrier_normal.dds	mod
super_transport_viii_escort_carrier_thruster_off.dds	mod
super_transport_viii_escort_carrier_thruster_off_normal.dds	mod
super_transport_viii_escort_carrier_thruster_on.dds	mod
sv_armored_assault_tank.dds	mod
sv_armored_assault_tank_2.dds	mod
sv_armored_assault_tank_2_b.dds	mod
sv_armored_assault_tank_b.dds	mod
t-65_x-wing_starfighter.dds	mod
t-65_x-wing_starfighter_normal.dds	mod
thruster.dds	unused?
tridroid.dds	unused?
ui_demolisher.dds	unused?
ui_demolisher_bc.dds	unused?
ui_tyber_scan_lines.tga	unused?
venator-class_star_crepublic.dds	mod
venator-class_star_destroyer.dds	mod
venator-class_star_destroyer_normal.dds	mod
victory1.dds	unused?
victory1_hull.dds	unused?
victory1_hull_normal.dds	unused?
victory1_normal.dds	unused?
viscount.dds	unused?
viscount_b.dds	unused?
viscount_l.dds	unused?
vsd1.dds	unused?
vsd1_normal.dds	unused?
weap_e_11_blaster.dds	mod
weap_e_11_blaster_b.dds	mod
weap_rt_97c_blaster.dds	unused?
weap_rt_97c_blaster_b.dds	unused?
weap_tl_50_blaster.dds	unused?
weap_tl_50_blaster_b.dds	unused?
weap_t_21_blaster.dds	unused?
weap_t_21_blaster_b.dds	unused?
wear_human_male_body_jetpacktrooperpack_jetpacktrooper_b.dds	unused?
wear_human_male_body_jetpacktrooperpack_jetpacktrooper_c.dds	unused?
wear_human_male_head_clonehelm_white_b.dds	unused?
wear_human_male_head_clonehelm_white_c.dds	unused?
w_beam_green.dds	unused?
w_bespin_buildings.dds	unused?
w_bespin_buildings_b.dds	unused?
w_black_hole.dds	unused?
w_blank_skin.dds	unused?
w_blast00.dds	unused?
w_blaster.dds	unused?
w_buildinglights_3.dds	unused?
w_empty_blackness.dds	mod
w_flag_empire.dds	unused?
w_galaxy_line.dds	mod
w_genericlights_tile.dds	unused?
w_ion_dmg.dds	unused?
w_junkpile.dds	unused?
w_junkpile_b.dds	unused?
w_junk_crawler_parts.dds	unused?
w_junk_crawler_parts_b.dds	unused?
w_junk_crawler_rear.dds	unused?
w_junk_crawler_rear_b.dds	unused?
w_junk_crawler_side.dds	unused?
w_junk_crawler_side_b.dds	unused?
w_junk_crawler_top.dds	unused?
w_junk_crawler_top_b.dds	unused?
w_junk_engine.dds	unused?
w_junk_engine_b.dds	unused?
w_junk_grill.dds	unused?
w_junk_grill_b.dds	unused?
w_junk_mechanical.dds	unused?
w_junk_mechanical_b.dds	unused?
w_junk_plate_a.dds	unused?
w_junk_plate_a_b.dds	unused?
w_junk_plate_b.dds	unused?
w_junk_plate_b_b.dds	unused?
w_junk_ship_girder.dds	unused?
w_junk_ship_girder_b.dds	unused?
w_junk_ship_nose_ext.dds	unused?
w_junk_ship_nose_ext_b.dds	unused?
w_junk_ship_nose_int.dds	unused?
w_junk_ship_nose_int_b.dds	unused?
w_junk_ship_parts_edges.dds	unused?
w_junk_ship_parts_edges_b.dds	unused?
w_junk_ship_parts_rusty_dark.dds	unused?
w_junk_ship_parts_rusty_dark_b.dds	unused?
w_junk_ship_parts_rusty_light.dds	unused?
w_junk_ship_parts_rusty_light_b.dds	unused?
w_junk_ship_turbine.dds	unused?
w_junk_ship_turbine_b.dds	unused?
w_junk_ship_turbine_int.dds	unused?
w_junk_ship_turbine_int_b.dds	unused?
w_junk_tank_grey.dds	unused?
w_junk_tank_grey_b.dds	unused?
w_junk_treads_side.dds	unused?
w_junk_treads_side_b.dds	unused?
w_junk_turbine.dds	unused?
w_junk_turbine_b.dds	unused?
w_landmine_oldbf2.dds	mod
w_laser.dds	unused?
w_laser_rebel.dds	unused?
w_laser_red.dds	unused?
w_laser_smabl.dds	unused?
w_laser_smal2.dds	unused?
w_laser_small.dds	mod
w_laser_small3.dds	unused?
w_laser_small9.dds	unused?
w_laser_smaly.dds	unused?
w_lightbar_fade.dds	unused?
w_lightcircle.dds	unused?
w_nebula_wrap_t.dds	unused?
w_nemsmoke_dark.dds	unused?
w_planetclouds_custom2.dds	unused?
w_planetclouds_light.dds	unused?
w_planetclouds_light_bc.dds	unused?
w_planetclouds_med.dds	unused?
w_planetclouds_med_bc.dds	unused?
w_planetclouds_none.dds	unused?
w_planetclouds_pin.dds	unused?
w_planetclouds_thick.dds	unused?
w_planetclouds_thickist.dds	unused?
w_planetclouds_thickist_bc.dds	unused?
w_planetclouds_thick_bc.dds	unused?
w_planetclouds_tiled.dds	unused?
w_planetclouds_tiled_bc.dds	unused?
w_planet_abregado.dds	unused?
w_planet_abregado_bc.dds	unused?
w_planet_abregado_low.dds	unused?
w_planet_abregado_low_bc.dds	unused?
w_planet_aeten_ii.dds	unused?
w_planet_aeten_ii_bc.dds	unused?
w_planet_aeten_ii_low.dds	unused?
w_planet_aeten_ii_low_bc.dds	unused?
w_planet_alderaan.dds	unused?
w_planet_alderaan_bc.dds	unused?
w_planet_alderaan_low.dds	unused?
w_planet_alderaan_low_bc.dds	unused?
w_planet_alzoc.dds	unused?
w_planet_alzoc_bc.dds	unused?
w_planet_alzoc_low.dds	unused?
w_planet_alzoc_low_bc.dds	unused?
w_planet_anaxes.dds	unused?
w_planet_anaxes_bc.dds	unused?
w_planet_anaxes_low.dds	unused?
w_planet_anaxes_low_bc.dds	unused?
w_planet_antar.dds	unused?
w_planet_antar_bc.dds	unused?
w_planet_antar_low.dds	unused?
w_planet_antar_low_bc.dds	unused?
w_planet_ant_low_bc.dds	unused?
w_planet_atzerri.dds	unused?
w_planet_atzerri_bc.dds	unused?
w_planet_atzerri_low.dds	unused?
w_planet_atzerri_low_bc.dds	unused?
w_planet_bakur.dds	unused?
w_planet_bakur_bc.dds	unused?
w_planet_bakur_low.dds	unused?
w_planet_bakur_low_bc.dds	unused?
w_planet_balmorra.dds	unused?
w_planet_balmorra_bc.dds	unused?
w_planet_bestin.dds	unused?
w_planet_black_hole.dds	unused?
w_planet_black_hole_ring.dds	unused?
w_planet_bonadan.dds	unused?
w_planet_bonadan_low.dds	unused?
w_planet_bothawui.dds	unused?
w_planet_bothawui_bc.dds	unused?
w_planet_bothawui_low.dds	unused?
w_planet_bothawui_low_bc.dds	unused?
w_planet_boz_pity.dds	unused?
w_planet_boz_pity_bc.dds	unused?
w_planet_boz_pity_low.dds	unused?
w_planet_boz_pity_low_bc.dds	unused?
w_planet_carida.dds	unused?
w_planet_carida_b.dds	unused?
w_planet_carida_low.dds	unused?
w_planet_carida_low_b.dds	unused?
w_planet_conqueror_dish.dds	unused?
w_planet_conqueror_dish_bc.dds	unused?
w_planet_corellia.dds	unused?
w_planet_corellia_bc.dds	unused?
w_planet_corellia_low.dds	unused?
w_planet_corellia_low_bc.dds	unused?
w_planet_dantooine.dds	unused?
w_planet_dantooine_bc.dds	unused?
w_planet_dantooine_low.dds	unused?
w_planet_dantooine_low_bc.dds	unused?
w_planet_dathomir1.dds	unused?
w_planet_dathomir1_bc.dds	unused?
w_planet_dathomir1_low.dds	unused?
w_planet_dathomir1_low_bc.dds	unused?
w_planet_duro00.dds	unused?
w_planet_duro00_bc.dds	unused?
w_planet_duro00_low.dds	unused?
w_planet_duro00_low_bc.dds	unused?
w_planet_endor.dds	unused?
w_planet_endor_bc.dds	unused?
w_planet_endor_low.dds	unused?
w_planet_endor_low_bc.dds	unused?
w_planet_eriadu.dds	unused?
w_planet_eriadu00_bc.dds	unused?
w_planet_eriadu00_low_bc.dds	unused?
w_planet_eriadu_low.dds	unused?
w_planet_felucia.dds	unused?
w_planet_felucia1_bc.dds	unused?
w_planet_felucia1_low_bc.dds	unused?
w_planet_felucia_low.dds	unused?
w_planet_foerost.dds	unused?
w_planet_foerost_bc.dds	unused?
w_planet_foerost_low.dds	unused?
w_planet_foerost_low_bc.dds	unused?
w_planet_fondor.dds	unused?
w_planet_fondor_bc.dds	unused?
w_planet_fondor_low.dds	unused?
w_planet_fondor_low_bc.dds	unused?
w_planet_fresi.dds	unused?
w_planet_fresi_bc.dds	unused?
w_planet_fresi_low.dds	unused?
w_planet_fresi_low_bc.dds	unused?
w_planet_gas.dds	unused?
w_planet_gasred.dds	unused?
w_planet_gas_antarr.dds	unused?
w_planet_gas_low_bc.dds	unused?
w_planet_gas_silver.dds	unused?
w_planet_geonosis.dds	unused?
w_planet_geonosis_bc.dds	unused?
w_planet_geonosis_low.dds	unused?
w_planet_geonosis_low_bc.dds	unused?
w_planet_honoghr1.dds	unused?
w_planet_honoghr1_bc.dds	unused?
w_planet_honoghr1_low.dds	unused?
w_planet_honoghr1_low_bc.dds	unused?
w_planet_hypori.dds	unused?
w_planet_hypori_bc.dds	unused?
w_planet_hypori_low.dds	unused?
w_planet_hypori_low_bc.dds	unused?
w_planet_ice.dds	unused?
w_planet_ice_bc.dds	unused?
w_planet_ilum.dds	unused?
w_planet_ilum_bc.dds	unused?
w_planet_ilum_low.dds	unused?
w_planet_ilum_low_bc.dds	unused?
w_planet_ithor.dds	unused?
w_planet_ithor_bc.dds	unused?
w_planet_ithor_low.dds	unused?
w_planet_ithor_low_bc.dds	unused?
w_planet_jabiim.dds	unused?
w_planet_jabiim_bc.dds	unused?
w_planet_jabiim_low.dds	unused?
w_planet_jabiim_low_bc.dds	unused?
w_planet_kashyyyk.dds	unused?
w_planet_kashyyyk_bc.dds	unused?
w_planet_kashyyyk_low.dds	unused?
w_planet_kashyyyk_low_bc.dds	unused?
w_planet_korrib.dds	unused?
w_planet_korriban.dds	unused?
w_planet_korriban_bc.dds	unused?
w_planet_korrib_bc.dds	unused?
w_planet_korrib_low.dds	unused?
w_planet_korrib_low_bc.dds	unused?
w_planet_kuat0.dds	unused?
w_planet_kuat0_bc.dds	unused?
w_planet_kuat0_low.dds	unused?
w_planet_kuat0_low_bc.dds	unused?
w_planet_mechis.dds	unused?
w_planet_mechis_bc.dds	unused?
w_planet_mechis_low.dds	unused?
w_planet_mechis_low_bc.dds	unused?
w_planet_munnilins.dds	unused?
w_planet_munnilins_bc.dds	unused?
w_planet_munnilins_low.dds	unused?
w_planet_munnilins_low_bc.dds	unused?
w_planet_naboo1.dds	unused?
w_planet_naboo1_bc.dds	unused?
w_planet_naboo1_low.dds	unused?
w_planet_naboo1_low_bc.dds	unused?
w_planet_neimoidia.dds	unused?
w_planet_neimoidia_bc.dds	unused?
w_planet_neimoidia_low.dds	unused?
w_planet_neimoidia_low_bc.dds	unused?
w_planet_ordma.dds	unused?
w_planet_ordmantel.dds	unused?
w_planet_ordmantel_bc.dds	unused?
w_planet_ordmantel_low.dds	unused?
w_planet_ordmantel_low_bc.dds	unused?
w_planet_ordma_low.dds	unused?
w_planet_rattatak.dds	unused?
w_planet_rattatak_bc.dds	unused?
w_planet_rattatak_low.dds	unused?
w_planet_rattatak_low_bc.dds	unused?
w_planet_raxusp.dds	unused?
w_planet_raxusp_bc.dds	unused?
w_planet_raxusp_low.dds	unused?
w_planet_raxusp_low_bc.dds	unused?
w_planet_rendilli.dds	unused?
w_planet_rendilli_bc.dds	unused?
w_planet_rendilli_low.dds	unused?
w_planet_rendilli_low_bc.dds	unused?
w_planet_rhen_var.dds	unused?
w_planet_rhen_var_bc.dds	unused?
w_planet_rhen_var_low.dds	unused?
w_planet_rhen_var_low_bc.dds	unused?
w_planet_rothan.dds	unused?
w_planet_rothan_bc.dds	unused?
w_planet_rothan_low.dds	unused?
w_planet_rothan_low_bc.dds	unused?
w_planet_ryloth.dds	unused?
w_planet_ryloth_low.dds	unused?
w_planet_saleucami.dds	unused?
w_planet_saleucami_bc.dds	unused?
w_planet_saleucami_low.dds	unused?
w_planet_saleucami_low_bc.dds	unused?
w_planet_sluisv.dds	unused?
w_planet_sluisv_bc.dds	unused?
w_planet_sluisv_low.dds	unused?
w_planet_sluisv_low_bc.dds	unused?
w_planet_taris.dds	unused?
w_planet_taris_low.dds	unused?
w_planet_tatooine.dds	unused?
w_planet_tatooine_bc.dds	unused?
w_planet_tatooine_low_bc.dds	unused?
w_planet_thule00.dds	unused?
w_planet_thule00_bc.dds	unused?
w_planet_thule00_low.dds	unused?
w_planet_thule00_low_bc.dds	unused?
w_planet_thyferra0.dds	unused?
w_planet_thyferra0_bc.dds	unused?
w_planet_thyferra0_low.dds	unused?
w_planet_thyferra0_low_bc.dds	unused?
w_planet_urban.dds	unused?
w_planet_urban_bc.dds	unused?
w_pts.dds	unused?
w_raxus_junk.dds	unused?
w_raxus_junk_bc.dds	unused?
w_sky_bespin1.dds	unused?
w_sky_bespin2.dds	unused?
w_sky_bespin3.dds	unused?
w_smoke.dds	unused?
w_sparkle.dds	unused?
w_sparkle1.dds	unused?
w_sparkle1.tga	unused?
w_sparkle_dim.dds	unused?
w_sparks_glow.dds	unused?
w_sparks_glow_b.dds	unused?
w_sparks_lrg.dds	unused?
w_stars_10rela03.dds	unused?
w_stars_11rela03.dds	unused?
w_stars_12rela03.dds	unused?
w_stars_12rela0344.dds	unused?
w_stars_13rela03.dds	unused?
w_stars_14rela03.dds	unused?
w_stars_15rela03.dds	unused?
w_stars_16rela03.dds	unused?
w_stars_1arela03.dds	unused?
w_stars_2arela03.dds	unused?
w_stars_3arela03.dds	unused?
w_stars_4arela03.dds	unused?
w_stars_5arela03.dds	unused?
w_stars_6arela03.dds	unused?
w_stars_7arela03.dds	unused?
w_stars_8arela03.dds	unused?
w_stars_9arela03.dds	unused?
w_stars_aweela00.dds	unused?
w_stars_aweela01.dds	unused?
w_stars_corela00.dds	unused?
w_stars_corela01.dds	unused?
w_stars_corela02.dds	unused?
w_stars_corela03.dds	unused?
w_stars_corela04.dds	unused?
w_stars_firela03.dds	unused?
w_stars_frrela04.dds	unused?
w_stars_nebula00.dds	unused?
w_stars_nebula01.dds	unused?
w_stars_nebula02.dds	unused?
w_stars_nebula03.dds	unused?
w_stars_nebula04.dds	unused?
w_stars_nebula05.dds	unused?
w_stars_nebula06.dds	unused?
w_stars_nebula07.dds	unused?
w_stars_nebula08.dds	unused?
w_stars_nebula09.dds	unused?
w_stars_nebula10.dds	unused?
w_stars_nebula11.dds	unused?
w_stars_nebula12.dds	unused?
w_stars_nebula13.dds	unused?
w_stars_nebula14.dds	unused?
w_stars_nebula15.dds	unused?
w_stars_nebula16.dds	unused?
w_stars_nebula17.dds	unused?
w_stars_nebula18.dds	unused?
w_stars_nebula19.dds	unused?
w_stars_nebula20.dds	unused?
w_stars_nebula21.dds	unused?
w_stars_nebula22.dds	unused?
w_stars_nebula23.dds	unused?
w_stars_nebula24.dds	unused?
w_stars_nebula25.dds	unused?
w_stars_nebula26.dds	unused?
w_stars_nebula27.dds	unused?
w_stars_nebula28.dds	unused?
w_stars_nebula29.dds	unused?
w_stars_nebula30.dds	unused?
w_stars_nebula31.dds	unused?
w_stars_nebula32.dds	unused?
w_stars_nebula33.dds	unused?
w_stars_nebula34.dds	unused?
w_stars_nebula35.dds	unused?
w_stars_nebula36.dds	unused?
w_stars_nebula37.dds	unused?
w_stars_nebula38.dds	unused?
w_stars_nebula39.dds	unused?
w_stars_nebula40.dds	unused?
w_stars_nebula41.dds	unused?
w_stars_nebula42.dds	unused?
w_stars_nebula43.dds	unused?
w_stars_nebula44.dds	unused?
w_stars_nebula45.dds	unused?
w_stars_nebula46.dds	unused?
w_stars_nebula47.dds	unused?
w_stars_nebula48.dds	unused?
w_stars_nebula49.dds	unused?
w_stars_nebula50.dds	unused?
w_stars_nebula51.dds	unused?
w_stars_nebula52.dds	unused?
w_stars_nebula53.dds	unused?
w_stars_nebula54.dds	unused?
w_stars_nebula55.dds	unused?
w_stars_nebula56.dds	unused?
w_stars_nebula57.dds	unused?
w_stars_nebula58.dds	unused?
w_stars_nebula59.dds	unused?
w_stars_nebula60.dds	unused?
w_stars_nebula61.dds	unused?
w_stars_nebula62.dds	unused?
w_stars_nebula63.dds	unused?
w_stars_nebula64.dds	unused?
w_stars_nebula65.dds	unused?
w_stars_nebula66.dds	unused?
w_stars_nebula67.dds	unused?
w_stars_nebula68.dds	unused?
w_stars_nebula69.dds	unused?
w_stars_nebulaa4.dds	unused?
w_stars_nebulaa8.dds	unused?
w_stars_nebulaa9.dds	unused?
w_stars_nebulab2.dds	unused?
w_stars_nebulab3.dds	unused?
w_stars_nebulab4.dds	unused?
w_stars_nebulab5.dds	unused?
w_stars_nebulab6.dds	unused?
w_stars_orrela03.dds	unused?
w_stars_orrela36.dds	unused?
w_stars_orrela37.dds	unused?
w_stars_outer.dds	unused?
w_stars_sirela03.dds	unused?
w_stars_sprela03.dds	unused?
w_stars_sun00.dds	mod
w_stars_sun01.dds	unused?
w_stars_sun02.dds	unused?
w_stars_sun03.dds	unused?
w_stars_sun04.dds	unused?
w_stars_sun05.dds	unused?
w_star_bkgnd.dds	mod
w_star_bkgnd_cine.dds	unused?
w_star_bkgnd_dense.dds	mod
w_star_bkgnd_light.dds	mod
w_sunflare_fade.dds	unused?
w_tie_holder.dds	unused?
w_tie_holder_beam.dds	unused?
w_tie_holder_beam_b.dds	unused?
w_tie_holder_doorframe.dds	unused?
w_tie_holder_doorframe_b.dds	unused?
w_white_missile.dds	unused?
xtraparts.dds	unused?
xtraparts_n.dds	unused?
_land_planet_omman_00.dds	unused?
_land_planet_raxus_prime_00.dds	unused?
