181_st_defender.alo	mod
181_st_interceptor.alo	mod
a-a5_speeder_truck.alo	mod
a-a5_speeder_truck_g.alo	mod
a-a5_speeder_truck_l.alo	mod
aa-turret.alo	mod
apart 1.alo	unused?
apart 2.alo	unused?
arc-170_starfighter.alo	mod
arc-170_starfighter_republic.alo	mod
armored_freerunner.alo	mod
armored_freerunner_b_01.alo	mod
armored_freerunner_b_02.alo	mod
armored_freerunner_dl.alo	mod
arrow-23_landspeeder.alo	mod
arrow-23_landspeeder_g.alo	mod
arrow-23_landspeeder_l.alo	mod
b-wing.alo	mod
bacta.alo	mod
barricade1.alo	mod
barricade2.alo	mod
barricade3.alo	mod
barricade4.alo	mod
bench.alo	mod
blue_diver.alo	mod
blue_diver_d.alo	mod
btl_k-wing.alo	mod
btl_y-wing.alo	mod
cato.alo	unused?
cc-7700efrigate.alo	mod
cc-7700_frigate.alo	mod
century_tank.alo	mod
century_tank_ltl.alo	mod
cerea.alo	unused?
cis_aat.alo	mod
cis_planetary_gun.alo	unused?
conteiner(1).alo	unused?
conteiner.alo	mod
conteiner2(1).alo	unused?
conteiner2.alo	mod
conteiner2gr(1).alo	unused?
conteiner2gr.alo	mod
conteiner3(1).alo	unused?
conteiner3.alo	mod
conteiner3gr(1).alo	unused?
conteiner3gr.alo	mod
conteiner4(1).alo	unused?
conteiner4.alo	mod
conteiner4gr(1).alo	unused?
conteiner4gr.alo	mod
conteiner5(1).alo	unused?
conteiner5.alo	mod
conteiner5gr(1).alo	unused?
conteiner5gr.alo	mod
cor1.alo	mod
cor10.alo	mod
cor2.alo	mod
cor3.alo	mod
cor4.alo	mod
cor5.alo	mod
cor6.alo	mod
cor7.alo	mod
cor8.alo	mod
cor9.alo	mod
corr wall 2 inside.alo	unused?
corr wall 2 long.alo	unused?
corr wall 2 out.alo	unused?
corr wall 2 shot.alo	unused?
corr wall inside.alo	unused?
corr wall long.alo	unused?
corr wall out.alo	unused?
corr wall shot.alo	unused?
curb corner.alo	unused?
curb m.alo	unused?
curb s.alo	unused?
cv_bulwark_mk1_rebel.alo	mod
cv_bulwark_mk1_rebel_d.alo	mod
cv_lucrehulk.alo	mod
cv_lucrehulk_dcs.alo	mod
cv_munificent.alo	mod
cv_munificent_rebel.alo	mod
cv_providence.alo	mod
cv_recusant.alo	mod
cv_recusant_rebel.alo	mod
diamoncruiser.alo	mod
dominator_i-class_star_destroyer.alo	mod
dominator_iii-class_star_destroyer.alo	mod
e-wing.alo	mod
ei_armygeneral.alo	mod
ei_armytrooper.alo	mod
ei_army_lieutenant_e11.alo	mod
ei_army_lieutenant_e15.alo	mod
ei_army_sergeant_e11.alo	mod
ei_army_sergeant_e15.alo	mod
ei_army_trooper_e11.alo	mod
ei_army_trooper_e15.alo	mod
ei_brakiss.alo	mod
ei_darktrooperatat.alo	mod
ei_fieldcomandere11.alo	mod
ei_imperial_army_e-web15_crew.alo	mod
ei_imperial_army_e-web_crew.alo	mod
ei_trooper_lt.alo	mod
ei_trooper_sand.alo	vanilla
ei_trooper_sgt.alo	mod
enforcership.alo	mod
enforcership_d.alo	mod
ev_13x.alo	mod
ev_a9_floating_fortress.alo	mod
ev_a9_floating_fortress_turret_l.alo	mod
ev_a9_floating_fortress_turret_r.alo	mod
ev_archammer.alo	vanilla
ev_at-st.alo	vanilla
ev_at_aa.alo	mod
ev_at_aa_turret.alo	mod
ev_at_dp.alo	mod
ev_demolisher.alo	mod
ev_demolisher_d.alo	mod
ev_executor_star_dreadnaught.alo	mod
ev_ja5.alo	mod
ev_knight_hammer.alo	mod
ev_laat.alo	mod
ev_maat.alo	mod
ev_missile_ship.alo	vanilla
ev_mobile_artillery.alo	mod
ev_podwalkermk1.alo	unused?
ev_praetor_mkii.alo	mod
ev_s1_firehawke.alo	mod
ev_s1_firehawke_00.alo	mod
ev_s1_firehawke_01.alo	mod
ev_sentinel.alo	mod
ev_sentinel_space.alo	mod
ev_tieavenger.alo	mod
ev_tiehunter.alo	mod
ev_tie_defender.alo	vanilla
ev_tie_starhunter.alo	mod
ev_turbulent.alo	mod
ev_victory1.alo	mod
ev_victory1_death.alo	mod
ev_victory2.alo	mod
ev_victory2_death.alo	mod
ev_victory_lp.alo	mod
facade01.alo	unused?
facade02.alo	unused?
ffh_rv_kdy_endurance.alo	mod
ffh_rv_new_nebula_defendersd.alo	mod
f_allegiance.alo	mod
f_allegiance_d.alo	mod
f_assault.alo	mod
f_assault_d.alo	mod
f_bothan.alo	mod
f_bothan_d.alo	mod
f_carrack.alo	mod
f_carrack_d.alo	mod
f_corellian_gunship.alo	mod
f_corellian_gunship_d.alo	mod
f_dauntless.alo	mod
f_dauntless_d.alo	mod
f_dreadnought.alo	mod
f_dreadnought_d.alo	mod
f_ferret.alo	mod
f_gunboat.alo	mod
f_independence.alo	mod
f_independence_d.alo	mod
f_lancer.alo	mod
f_lancer_d.alo	mod
f_liberator.alo	mod
f_liberator_d.alo	mod
f_loronar.alo	mod
f_loronar_d.alo	mod
f_majestic.alo	mod
f_majestic_d.alo	mod
f_mc40b.alo	mod
f_mc40b_d.alo	mod
f_mc80b.alo	mod
f_mc80b_d.alo	mod
f_mc80c.alo	mod
f_mc80c_d.alo	mod
f_mc85.alo	mod
f_mc85_d.alo	mod
f_mc90.alo	mod
f_mc90_d.alo	mod
f_missile_gunboat.alo	mod
f_nebulonb.alo	mod
f_nebulonb2.alo	mod
f_nebulonb2_d.alo	mod
f_nebulonb_d.alo	mod
f_sacheen.alo	mod
f_sacheen_d.alo	mod
galaxy_destroyer.alo	mod
galaxy_destroyer_d.alo	mod
hammerhead_crashed.alo	mod
heavy_tracker.alo	mod
heavy_tracker_hl.alo	mod
imp computer.alo	unused?
imp crawler.alo	unused?
imp manned turret.alo	unused?
imperial_i-class_star_destroyer.alo	mod
imperial_i-class_star_destroyer_hdti_00.alo	mod
imperial_i-class_star_destroyer_hdti_01.alo	mod
imperial_i-class_star_destroyer_hdtl_00.alo	mod
imperial_i-class_star_destroyer_hdtl_01.alo	mod
imperial_i-class_star_destroyer_hdtl_02.alo	mod
imperial_i-class_star_destroyer_hdtl_03.alo	mod
imperial_i-class_star_destroyer_hdtl_04.alo	mod
imperial_i-class_star_destroyer_hdtl_05.alo	mod
imperial_ii-class_star_destroyer.alo	mod
imperial_ii-class_star_destroyer_black.alo	mod
imperial_ii-class_star_destroyer_hoti_00.alo	mod
imperial_ii-class_star_destroyer_hoti_01.alo	mod
imperial_ii-class_star_destroyer_hotl_00.alo	mod
imperial_ii-class_star_destroyer_hotl_01.alo	mod
imperial_ii-class_star_destroyer_hotl_02.alo	mod
imperial_ii-class_star_destroyer_hotl_03.alo	mod
imperial_ii-class_star_destroyer_hotl_04.alo	mod
imperial_ii-class_star_destroyer_hotl_05.alo	mod
kas bench.alo	unused?
kas kiosk.alo	unused?
lambda-class_t-4_shuttle.alo	mod
marauder-class_corvette.alo	mod
medical bed1.alo	unused?
medical bed2.alo	unused?
midcywall inside.alo	unused?
midcywall long.alo	unused?
midcywall outside.alo	unused?
midcywall shot.alo	unused?
midcywall windowed inside.alo	unused?
midcywall windowed long.alo	unused?
midcywall windowed outside.alo	unused?
midcywall windowed shot.alo	unused?
modular_taskforce_cruiser.alo	mod
nom_misc_hutt_banner_01.alo	mod
nom_misc_hutt_banner_02.alo	mod
nom_misc_hutt_banner_03.alo	mod
nom_misc_hutt_banner_04.alo	mod
nom_misc_imperial_banner_01.alo	mod
nom_misc_imperial_banner_02.alo	mod
nom_misc_imperial_banner_03.alo	mod
nom_misc_imperial_banner_04.alo	mod
nv_consular_wreck.alo	mod
nv_gozanti_wreck.alo	mod
nv_space_build_center.alo	mod
nv_vwing_republic.alo	mod
parkwall inside.alo	unused?
parkwall long.alo	unused?
parkwall out.alo	unused?
parkwall shot.alo	unused?
pe_acclamatorengines.alo	unused?
pe_acclamatorengines_sml.alo	unused?
pe_arc-170_engines.alo	unused?
pe_assaultcruiserengine.alo	unused?
pe_b-wing_engines.alo	unused?
pe_blue_diver_l.alo	unused?
pe_blue_diver_m.alo	unused?
pe_blue_diver_s.alo	unused?
pe_btl_k-wing_engines.alo	unused?
pe_btl_y-wing_engines.alo	unused?
pe_bulwark_mk1_large.alo	unused?
pe_bulwark_mk1_small.alo	unused?
pe_carrack_cruiser.alo	unused?
pe_cc-7700_engines.alo	unused?
pe_corvetteengines.alo	unused?
pe_diamondcruiser.alo	unused?
pe_e-wing_engines.alo	unused?
pe_executor.alo	unused?
pe_galaxy_l.alo	unused?
pe_galaxy_m.alo	unused?
pe_galaxy_s.alo	unused?
pe_imperial-class_engines_large.alo	unused?
pe_imperial-class_engines_small.alo	unused?
pe_interdictorengine_lrg.alo	unused?
pe_interdictorengine_med.alo	unused?
pe_interdictorengine_sml.alo	unused?
pe_ipv1engine.alo	unused?
pe_lancer_cruiser1.alo	unused?
pe_lucrehulk.alo	unused?
pe_lucrehulk_small.alo	unused?
pe_marauder-class_engine.alo	unused?
pe_mc30engine_lrg.alo	unused?
pe_mc30engine_sml.alo	unused?
pe_mc30engine_sml1.alo	unused?
pe_mediator.alo	unused?
pe_muniengines.alo	unused?
pe_muniengines_sml.alo	unused?
pe_nebula_destroyer_eng.alo	unused?
pe_nebulon_engines.alo	unused?
pe_praetor_mkii_lrg.alo	unused?
pe_praetor_mkii_med.alo	unused?
pe_praetor_mkii_sml.alo	unused?
pe_providence.alo	unused?
pe_r-41_engines_large.alo	unused?
pe_r-41_engines_medium.alo	unused?
pe_recuengines.alo	unused?
pe_republic-class_engines_large.alo	unused?
pe_republic-class_engines_medium.alo	unused?
pe_rep_corvette.alo	unused?
pe_rz-1_a-wing_engines.alo	unused?
pe_scimitar_engine.alo	unused?
pe_strident01.alo	unused?
pe_strident02.alo	unused?
pe_strident03.alo	unused?
pe_strident04.alo	unused?
pe_strike_cruiser1.alo	unused?
pe_strike_cruiser2.alo	unused?
pe_super_transport_viii_engines.alo	unused?
pe_t-65_x-wing_engines.alo	unused?
pe_tiebomberengine.alo	unused?
pe_tiescoutengine.alo	unused?
pe_tiescoutengines.alo	unused?
pe_turbulent_large.alo	unused?
pe_turbulent_small.alo	unused?
pe_vindicator__med.alo	unused?
pe_vindicator__sml.alo	unused?
pe_viscount_l.alo	unused?
pe_viscount_m.alo	unused?
pe_viscount_s.alo	unused?
pe_vwingengines.alo	unused?
pe_z-95_headhunter_engines.alo	unused?
pe___gladiator___.alo	unused?
pptw_aslash.alo	unused?
prop_mygeeto1.alo	mod
prop_mygeeto2.alo	mod
prop_mygeeto3.alo	mod
pte_assassinengines.alo	unused?
pte_b-wing_engines.alo	unused?
pte_btl_k-wing_booster.alo	unused?
pte_ipv1engine.alo	unused?
pte_rep_corvette.alo	unused?
pte_z-95_headhunter_engines.alo	unused?
px-10_compact_assault_vehicle.alo	mod
px-10_compact_assault_vehicle_b.alo	mod
p_artillery_shell.alo	mod
p_beam_green_small.alo	unused?
p_black_hole_gravity.alo	unused?
p_blink_white.alo	unused?
p_blue_trail.alo	unused?
p_bluglow.alo	unused?
p_carbonite_trail.alo	unused?
p_ciscussion.alo	unused?
p_concussion.alo	unused?
p_conc_diamd.alo	unused?
p_conc_heavy.alo	unused?
p_conc_level.alo	unused?
p_explosion_big00.alo	vanilla
p_explosion_big01.alo	vanilla
p_explosion_empire_big00.alo	vanilla
p_explosion_empire_big01.alo	mod
p_explosion_empire_friggin_huge00.alo	vanilla
p_explosion_empire_huge00.alo	vanilla
p_explosion_empire_huge00_no_debris.alo	vanilla
p_explosion_empire_med00.alo	vanilla
p_explosion_empire_small00.alo	vanilla
p_explosion_empire_tiny.alo	mod
p_explosion_friggin_huge00.alo	vanilla
p_explosion_huge00.alo	vanilla
p_explosion_huge01.alo	vanilla
p_explosion_med00.alo	vanilla
p_explosion_med01.alo	vanilla
p_explosion_small00.alo	vanilla
p_explosion_small01.alo	vanilla
p_explosion_small02.alo	unused?
p_explosion_thermal_small00.alo	vanilla
p_explosion_tiny.alo	mod
p_flak.alo	mod
p_flamethrower.alo	unused?
p_flamethrower00.alo	unused?
p_flamethrower01.alo	unused?
p_flame_rifle.alo	mod
p_galaxy_tion.alo	unused?
p_infantry_blaster_long.alo	mod
p_infantry_blaster_short.alo	mod
p_infantry_blaster_short_p.alo	mod
p_infantry_blaster_short_y.alo	mod
p_infantry_blast_cannon.alo	mod
p_infantry_bowcaster.alo	unused?
p_infantry_cspl_12.alo	mod
p_infantry_ion_disruptor.alo	mod
p_ionfigh.alo	unused?
p_ionshot.alo	unused?
p_landmine.alo	unused?
p_landrocket.alo	unused?
p_land_at_ar.alo	mod
p_land_at_at.alo	unused?
p_land_at_at_blaster.alo	unused?
p_land_at_st.alo	unused?
p_land_century_blaster.alo	mod
p_land_chariot.alo	unused?
p_land_e_web.alo	mod
p_land_firehawke.alo	unused?
p_land_flak_missile.alo	unused?
p_land_floating_fortress.alo	unused?
p_land_freerunner_blaster.alo	mod
p_land_freerunner_laser.alo	unused?
p_land_heavy_tracker.alo	unused?
p_land_light_turbolaser.alo	unused?
p_land_light_turbolaser_r.alo	unused?
p_land_missile.alo	unused?
p_land_px_10.alo	unused?
p_land_t3_b.alo	unused?
p_land_t4_b.alo	unused?
p_land_tx_130.alo	unused?
p_land_ulav_blaster.alo	unused?
p_mflashred_thin.alo	unused?
p_mptglow.alo	unused?
p_mptl_torpedo.alo	unused?
p_planetary_turbolaser.alo	mod
p_protonbomb.alo	unused?
p_proton_torpedo00.alo	unused?
p_proton_torpedo01.alo	unused?
p_proton_torpedo03.alo	unused?
p_proton_torpedo04.alo	unused?
p_redglow.alo	unused?
p_ri_engineer_cannon.alo	mod
p_salvation_fac.alo	mod
p_shield_blast_large00.alo	vanilla
p_shield_blast_large01.alo	mod
p_shield_blast_med00.alo	vanilla
p_shield_blast_small00.alo	vanilla
p_shocked_inf.alo	mod
p_shreddershot.alo	unused?
p_t33glow.alo	unused?
p_teezl.alo	unused?
p_turbolaser_blue.alo	unused?
p_turbolaser_green.alo	unused?
p_turbolaser_red.alo	unused?
qh-7_chariot_light_assault_vehicle.alo	mod
qh-7_chariot_light_assault_vehicle_l.alo	mod
r-22_a-wing.alo	mod
r-41_starchaser.alo	mod
rails fly support.alo	unused?
rails.alo	mod
rails_turn.alo	mod
rails_turn_with_supports.alo	mod
rails_with_support.alo	mod
rakatan.alo	unused?
rakatan_enclave.alo	unused?
rakatan_statue.alo	unused?
reef_home-class_mc80_star_cruiser.alo	mod
rep_corvette_03.alo	mod
rep_corvette_05.alo	mod
rev_acclamator1.alo	mod
rev_acclamator1_d.alo	mod
ri_antitrooper_dc15a.alo	mod
ri_corran_horn.alo	mod
ri_kota.alo	mod
ri_kyle_jedi.alo	mod
ri_newrinfantryplex_desert.alo	unused?
ri_newrinfantryplex_forest.alo	mod
ri_newrinfantryplex_snow.alo	mod
ri_newrinfantryplex_urban.alo	mod
ri_newrinfantry_desert.alo	mod
ri_newrinfantry_forest.alo	mod
ri_newrinfantry_snow.alo	mod
ri_newrinfantry_urban.alo	mod
ri_vanguard_desert.alo	mod
ri_vanguard_jungle.alo	mod
ri_vanguard_snow.alo	mod
ri_vanguard_urban.alo	mod
road flat 3 ways.alo	unused?
road flat 4 ways.alo	unused?
road flat long.alo	unused?
road flat.alo	unused?
road turn.alo	unused?
rv_aac_hovertank.alo	mod
rv_lusankya.alo	mod
rv_mediator_battlecruiser.alo	mod
rv_mediator_cruiser_d.alo	mod
rv_ranger.alo	mod
rv_ranger_d.alo	mod
rv_salvation.alo	mod
rv_t-1b.alo	mod
rv_t-1b_00.alo	mod
rv_t-1b_01.alo	mod
rv_t2_b.alo	mod
rv_t2_b_00.alo	mod
rv_t3-b.alo	mod
rv_t3-b_00.alo	mod
rv_t4_b.alo	mod
rv_t4_b_00.alo	mod
rv_ulav.alo	mod
rv_ulav_turret_01.alo	mod
rv_viscount_class_star_defender.alo	mod
rv_vwing.alo	mod
rv_wildkarrde.alo	mod
rv_wildkarrde_die.alo	mod
rz-1_a-wing.alo	mod
scimitar_assault_bomber.alo	mod
sev_carrier.alo	mod
sev_droid_bomber.alo	mod
sev_tridroid.alo	mod
sev_vulture.alo	mod
sign1 test.alo	unused?
sign1.alo	unused?
sign2.alo	mod
sign3.alo	mod
sign4.alo	mod
sovereign-class_star_dreadnought.alo	mod
statue.alo	mod
street light 2.alo	unused?
street light.alo	unused?
street sign.alo	unused?
street sign2.alo	unused?
strident.alo	mod
strident_d.alo	mod
strident_turret12.alo	mod
strident_turret13.alo	mod
strident_turret14.alo	mod
strident_turret15.alo	mod
super_transport_viii_escort_carrier.alo	mod
sv_armored_assault_tank.alo	mod
sv_armored_assault_tank_00.alo	mod
sv_armored_assault_tank_01.alo	mod
t-65_x-wing_starfighter.alo	mod
tector_i-class_star_destroyer.alo	mod
tent b.alo	unused?
tent bed.alo	unused?
tent m.alo	unused?
tent s.alo	unused?
train.alo	mod
tram tunnel in.alo	unused?
transport1.alo	mod
transport2.alo	mod
transport3.alo	mod
transport4.alo	mod
transport5.alo	mod
transport5b.alo	mod
transport5p.alo	mod
transport5r.alo	mod
trim_station.alo	mod
turret.alo	mod
ugc_ce_prop_tatooine_01.alo	mod
ugc_ce_prop_tatooine_01_ald.alo	mod
ugc_ce_prop_tatooine_01_copper.alo	mod
ugc_ce_prop_tatooine_02.alo	mod
ugc_ce_prop_tatooine_03.alo	mod
ugc_ce_prop_tatooine_04.alo	mod
ugc_ce_prop_tatooine_05.alo	mod
ugc_ce_prop_tatooine_06.alo	mod
ugc_ce_prop_tatooine_07.alo	mod
ugc_ce_prop_tatooine_07a.alo	mod
ugc_ce_prop_tatooine_astroport_a.alo	mod
ugc_ce_w_industrialwall_a.alo	unused?
ugc_ce_w_industrialwall_b.alo	unused?
venator-class_star_destroyer.alo	mod
venator-class_star_destroyer_hdtl_00.alo	mod
venator-class_star_destroyer_hdtl_01.alo	mod
venator-class_star_destroyer_hdtl_02.alo	mod
venator-class_star_destroyer_hdtl_03.alo	mod
venator-class_star_destroyer_hdtl_04.alo	mod
venator-class_star_destroyer_hdtl_05.alo	mod
venator-class_star_destroyer_hdtl_06.alo	mod
venator-class_star_destroyer_hdtl_07.alo	mod
venator-class_star_destroyer_republic.alo	mod
viscount_d.alo	mod
walkway end.alo	unused?
walkway long.alo	unused?
walkway shot.alo	unused?
walkway turn.alo	unused?
wallset doorway.alo	unused?
wallset inside.alo	unused?
wallset long.alo	unused?
wallset out.alo	unused?
wallset shot.alo	unused?
wallset stack.alo	unused?
w_aat_debris.alo	mod
w_beam_blue_small.alo	unused?
w_beam_green_small.alo	unused?
w_beam_red_small.alo	unused?
w_bush_rudrig_00.alo	mod
w_buzz_missile.alo	unused?
w_composite_beam.alo	mod
w_concussion_missile.alo	vanilla
w_concussion_missile2.alo	mod
w_concussion_missile3.alo	mod
w_diamd_missile.alo	mod
w_druckenwell_big_obelisk.alo	mod
w_druckenwell_house.alo	mod
w_druckenwell_platform.alo	mod
w_druckenwell_small_obelisk.alo	mod
w_dual_ion_cannon.alo	mod
w_dual_turbolaser_b.alo	mod
w_dual_turbolaser_g.alo	mod
w_dual_turbolaser_r.alo	mod
w_e_land_missile.alo	unused?
w_fighter_ion_cannon.alo	mod
w_flag_pod_empire.alo	mod
w_flag_pod_empire_standalone.alo	mod
w_flamethrower.alo	unused?
w_galaxy_tion.alo	unused?
w_grndcvr_rudrig_00.alo	mod
w_hardcell_debris.alo	mod
w_heavy_missile.alo	mod
w_junk_1.alo	mod
w_junk_2.alo	mod
w_junk_3.alo	mod
w_junk_3_b.alo	mod
w_junk_4.alo	mod
w_junk_5.alo	mod
w_junk_6.alo	mod
w_junk_6_b.alo	mod
w_junk_7.alo	mod
w_junk_8.alo	mod
w_junk_9.alo	mod
w_junk_crawler.alo	mod
w_junk_nose.alo	mod
w_junk_nozzle.alo	mod
w_junk_ship_girder.alo	mod
w_junk_starship_engine.alo	mod
w_junk_treads.alo	mod
w_landmine_oldbf2.alo	mod
w_land_flak_missile.alo	mod
w_land_missile.alo	mod
w_laser_land_g.alo	mod
w_laser_land_r.alo	mod
w_laser_smallb.alo	mod
w_leveler_missile.alo	mod
w_magpulsetorp.alo	mod
w_mptl_torpedo.alo	mod
w_mygeeto_building_a.alo	mod
w_mygeeto_building_b.alo	mod
w_mygeeto_building_c.alo	mod
w_mygeeto_building_d.alo	mod
w_mygeeto_building_e.alo	mod
w_mygeeto_corner_a.alo	mod
w_mygeeto_corner_b.alo	mod
w_mygeeto_lamp_a.alo	mod
w_mygeeto_wall_a.alo	mod
w_mygeeto_wall_b.alo	mod
w_mygeeto_wall_c.alo	mod
w_mygeeto_wall_d.alo	mod
w_octuple_turbolaser_g.alo	mod
w_planet_abregado_high.alo	unused?
w_planet_abregado_low.alo	unused?
w_planet_aeten2_high.alo	unused?
w_planet_aeten2_low.alo	unused?
w_planet_alzoc_high.alo	unused?
w_planet_alzoc_low.alo	unused?
w_planet_anaxes_high.alo	unused?
w_planet_anaxes_low.alo	unused?
w_planet_antar_high.alo	unused?
w_planet_antar_low.alo	unused?
w_planet_atzerri_high.alo	unused?
w_planet_atzerri_low.alo	unused?
w_planet_bakura_high.alo	unused?
w_planet_bakura_low.alo	unused?
w_planet_bestine_high.alo	unused?
w_planet_bestine_low.alo	unused?
w_planet_bothawui_high.alo	unused?
w_planet_bothawui_low.alo	unused?
w_planet_boz_pity_high.alo	unused?
w_planet_boz_pity_low.alo	unused?
w_planet_cadinth.alo	unused?
w_planet_carida_high.alo	unused?
w_planet_carida_low.alo	unused?
w_planet_cato_neimoidia_high.alo	unused?
w_planet_cato_neimoidia_low.alo	unused?
w_planet_corellia_high.alo	unused?
w_planet_corellia_low.alo	unused?
w_planet_coruscant_surface.alo	unused?
w_planet_dantooine_high.alo	unused?
w_planet_dantooine_low.alo	unused?
w_planet_dathomir_high.alo	unused?
w_planet_dathomir_low.alo	unused?
w_planet_dsii.alo	mod
w_planet_duro_high.alo	unused?
w_planet_duro_low.alo	unused?
w_planet_endor_giant.alo	mod
w_planet_endor_moon.alo	mod
w_planet_eriadu_high.alo	vanilla
w_planet_eriadu_low.alo	vanilla
w_planet_felucia_high.alo	unused?
w_planet_felucia_low.alo	unused?
w_planet_foerost_high.alo	unused?
w_planet_foerost_low.alo	unused?
w_planet_fondor_high.alo	unused?
w_planet_fondor_low.alo	unused?
w_planet_fresia_high.alo	unused?
w_planet_fresia_low.alo	unused?
w_planet_honoghr_high.alo	unused?
w_planet_honoghr_low.alo	unused?
w_planet_hypori_high.alo	unused?
w_planet_hypori_low.alo	unused?
w_planet_ilum_high.alo	unused?
w_planet_ilum_low.alo	unused?
w_planet_ithor_high.alo	unused?
w_planet_ithor_low.alo	unused?
w_planet_jabiim_high.alo	unused?
w_planet_jabiim_low.alo	unused?
w_planet_kashyyyk_high.alo	unused?
w_planet_kashyyyk_low.alo	unused?
w_planet_korriban01.alo	vanilla
w_planet_korriban_high.alo	unused?
w_planet_kuat_high.alo	vanilla
w_planet_mechis_high.alo	unused?
w_planet_mechis_low.alo	unused?
w_planet_munnilinst_high.alo	unused?
w_planet_munnilinst_low.alo	unused?
w_planet_naboo_high.alo	vanilla
w_planet_naboo_low.alo	vanilla
w_planet_omman.alo	mod
w_planet_omman_remake.alo	unused?
w_planet_ord_mantel00.alo	unused?
w_planet_ord_mantell_high.alo	unused?
w_planet_ord_mantell_low.alo	unused?
w_planet_rattatak_high.alo	unused?
w_planet_rattatak_low.alo	unused?
w_planet_raxus.alo	unused?
w_planet_raxus_prime_high.alo	unused?
w_planet_raxus_prime_low.alo	unused?
w_planet_rendilli_high.alo	unused?
w_planet_rendilli_low.alo	unused?
w_planet_rhen_var_high.alo	unused?
w_planet_rhen_var_low.alo	unused?
w_planet_rothana_high.alo	unused?
w_planet_rothana_low.alo	unused?
w_planet_saleucami_high.alo	unused?
w_planet_saleucami_low.alo	unused?
w_planet_sluisvan_high.alo	unused?
w_planet_sluisvan_low.alo	unused?
w_planet_thule_high.alo	unused?
w_planet_thule_low.alo	unused?
w_planet_thyferra_high.alo	unused?
w_planet_thyferra_low.alo	unused?
w_plasmatorp.alo	mod
w_protonbomb.alo	unused?
w_protontorp.alo	mod
w_quad_turbolaser_b.alo	mod
w_quad_turbolaser_g.alo	mod
w_quad_turbolaser_r.alo	mod
w_rhn_bridge.alo	mod
w_rhn_building.alo	mod
w_rhn_buttress.alo	unused?
w_rhn_citadel_tower_01.alo	mod
w_rhn_citadel_tower_02.alo	mod
w_rhn_common.alo	mod
w_rhn_common_02.alo	mod
w_rhn_gargoyle.alo	mod
w_rhn_lighthouse.alo	mod
w_rhn_lookout2.alo	unused?
w_rhn_obelisk.alo	mod
w_rhn_observatory.alo	mod
w_rhn_overlook.alo	mod
w_rhn_rotunda.alo	mod
w_rhn_stairs.alo	unused?
w_rhn_statue.alo	mod
w_rhn_statue_cracked.alo	mod
w_rhn_statue_snowy.alo	mod
w_rhn_tower.alo	mod
w_rhn_vista.alo	mod
w_rhn_vista2.alo	unused?
w_rudrig_sinkhole.alo	mod
w_ruins04.alo	unused?
w_ruins05.alo	unused?
w_ruins06.alo	unused?
w_ruins07.alo	unused?
w_single_ion_cannon.alo	mod
w_single_turbolaser_b.alo	mod
w_single_turbolaser_g.alo	mod
w_single_turbolaser_r.alo	mod
w_stars_cine.alo	vanilla
w_stars_high.alo	vanilla
w_stars_low.alo	vanilla
w_stars_maw.alo	vanilla
w_stars_medium.alo	vanilla
w_stars_nebula_13.alo	unused?
w_stars_nebula_14.alo	unused?
w_stars_nebula_15.alo	mod
w_stars_nebula_16.alo	mod
w_stars_nebula_17.alo	mod
w_stars_nebula_18.alo	mod
w_stars_nebula_19.alo	mod
w_stars_nebula_20.alo	mod
w_stars_nebula_21.alo	mod
w_stars_nebula_22.alo	mod
w_stars_nebula_23.alo	mod
w_stars_nebula_24.alo	mod
w_stars_nebula_25.alo	mod
w_stars_nebula_26.alo	mod
w_stars_nebula_27.alo	mod
w_stars_nebula_28.alo	mod
w_stars_nebula_29.alo	mod
w_stars_nebula_30.alo	mod
w_stars_nebula_31.alo	mod
w_stars_nebula_32.alo	mod
w_stars_nebula_33.alo	mod
w_stars_nebula_34.alo	mod
w_stars_nebula_35.alo	mod
w_stars_nebula_36.alo	mod
w_stars_nebula_37.alo	mod
w_stars_nebula_38.alo	mod
w_stars_nebula_39.alo	mod
w_stars_nebula_40.alo	mod
w_stars_nebula_41.alo	mod
w_stars_nebula_42.alo	mod
w_stars_nebula_43.alo	mod
w_stars_nebula_44.alo	mod
w_stars_nebula_45.alo	mod
w_stars_nebula_46.alo	mod
w_stars_nebula_47.alo	mod
w_stars_nebula_48.alo	mod
w_stars_nebula_49.alo	mod
w_stars_nebula_50.alo	mod
w_stars_nebula_51.alo	mod
w_stars_nebula_52.alo	mod
w_stars_nebula_53.alo	mod
w_stars_nebula_54.alo	mod
w_stars_nebula_55.alo	mod
w_stars_nebula_56.alo	mod
w_stars_nebula_57.alo	mod
w_stars_nebula_58.alo	mod
w_stars_nebula_59.alo	mod
w_stars_nebula_60.alo	mod
w_stars_nebula_61.alo	mod
w_stars_nebula_62.alo	mod
w_stars_nebula_63.alo	mod
w_stars_nebula_64.alo	mod
w_stars_nebula_65.alo	mod
w_stars_nebula_66.alo	mod
w_stars_nebula_67.alo	mod
w_stars_nebula_68.alo	mod
w_stars_nebula_69.alo	mod
w_stars_nebula_a4.alo	mod
w_stars_nebula_a8.alo	mod
w_stars_nebula_a9.alo	mod
w_stars_nebula_b2.alo	mod
w_stars_nebula_b3.alo	mod
w_stars_nebula_b4.alo	mod
w_stars_nebula_b5.alo	mod
w_stars_nebula_b6.alo	mod
w_stars_nebula_core_blueish_red.alo	mod
w_stars_nebula_core_brown.alo	mod
w_stars_nebula_core_green.alo	mod
w_stars_nebula_core_purple.alo	mod
w_stars_nebula_core_tan.alo	mod
w_stars_nebula_eight.alo	mod
w_stars_nebula_eleven.alo	mod
w_stars_nebula_fire.alo	mod
w_stars_nebula_fire_two.alo	mod
w_stars_nebula_five.alo	mod
w_stars_nebula_four.alo	mod
w_stars_nebula_nine.alo	mod
w_stars_nebula_one.alo	mod
w_stars_nebula_orion.alo	mod
w_stars_nebula_orion_blue.alo	mod
w_stars_nebula_orion_pink.alo	mod
w_stars_nebula_rotm1.alo	mod
w_stars_nebula_rotm2.alo	mod
w_stars_nebula_rotm3.alo	mod
w_stars_nebula_rotm4.alo	mod
w_stars_nebula_seven.alo	mod
w_stars_nebula_six.alo	mod
w_stars_nebula_spire.alo	mod
w_stars_nebula_spire_two.alo	mod
w_stars_nebula_ten.alo	mod
w_stars_nebula_three.alo	mod
w_stars_nebula_twelve.alo	mod
w_stars_nebula_two.alo	mod
w_theed_1.alo	mod
w_theed_10.alo	mod
w_theed_11.alo	mod
w_theed_12.alo	mod
w_theed_1b.alo	mod
w_theed_2.alo	mod
w_theed_2a.alo	mod
w_theed_2b.alo	mod
w_theed_2c.alo	mod
w_theed_3.alo	mod
w_theed_4.alo	mod
w_theed_4a.alo	mod
w_theed_4b.alo	mod
w_theed_4c.alo	mod
w_theed_5.alo	mod
w_theed_6.alo	mod
w_theed_7.alo	mod
w_theed_8.alo	mod
w_theed_9.alo	mod
w_theed_statue.alo	mod
w_tie_assembly_line_00.alo	mod
w_tie_assembly_line_01.alo	mod
w_tie_assembly_line_07.alo	mod
w_tie_cockpit.alo	mod
w_tie_in_panels_8.alo	mod
w_tie_ln_panels_8.alo	mod
w_white_missile.alo	mod
yt-1300_light_freighter.alo	mod
yt-1300_light_freighter_ql.alo	mod
yt-1300_light_freighter_rectenna.alo	mod
z-95_headhunter.alo	mod
