a-a5_speeder_truck_g.alo	Unused	[]
a-a5_speeder_truck_l.alo	Unused	[]
imp_elite_guard.alo	Unused	[]
imp_s1_firehawke.alo	Unused	[]
imp_s1_firehawke_01.alo	Unused	[]
proj_land_missile.alo	Unused	[]
proj_laser_land_g.alo	Unused	[]
p_ionfigh.alo	Unused	[]
p_ionshot.alo	Unused	[]
reb_freerunner_apc.alo	Unused	[]
reb_freerunner_com.alo	Unused	[]
reb_t2b.alo	Unused	[]
rv_aac_hovertank.alo	Unused	[]
rv_t-1b.alo	Unused	[]
rv_t-1b_00.alo	Unused	[]
rv_t-1b_01.alo	Unused	[]
rv_t2_b.alo	Unused	[]
sev_carrier.alo	Unused	[]
sign1.alo	Unused	[]
w_land_flak_missile.alo	Unused	[]
w_laser_land_r.alo	Unused	[]
w_planet_cadinth.alo	Unused	[]
w_planet_omman_remake.alo	Unused	[]
cin_rv_xwingprop.alo	Missing	['groundstructures.xml']
ev_s1_firehawke_00.alo	Missing	['hardpoints_land.xml']
ev_s1_firehawke_01.alo	Missing	['hardpoints_land.xml']
p_splash_wake_lava.alo	Missing	['particles.xml']
w_planet_w_black_hole_small.alo	Missing	['planets_no.xml']
w_allshaders.alo	Missing	['props_generic.xml']
w_droid_steam.alo	Missing	['props_generic.xml']
cin_bridge.alo	Missing	['props_story.xml']
cin_deathstar_high.alo	Missing	['props_story.xml']
w_tatooine_building01.alo	Missing	['props_yoden_desert.xml']
w_tatooine_building02.alo	Missing	['props_yoden_desert.xml']
w_tatooine_building03.alo	Missing	['props_yoden_desert.xml']
nb_idh.alo	Missing	['props_yoden_desert.xml']
w_fuel_pipe03.alo	Missing	['props_yoden_spaceprops.xml']
w_volcano_rock02.alo	Missing	['props_yoden_volcanic.xml']
prop_urban_astroport_a.alo	Missing	['ugc_ce_objects.xml']
ev_s1_firehawke.alo	Missing	['units_land_empire_s1_firehawke.xml']
reb_t_2b.alo	Missing	['units_land_rebel_t2b.xml']
ev_praetor_ii_d.alo	Missing	['units_space_empire_praetor_mkii.xml']
pte_arc-170_engines.alo	Missing	['arc-170_starfighter.alo', 'arc-170_starfighter_republic.alo']
p_explosion_chain03.alo	Missing	['blue_diver_d.alo']
pte_btl_k-wing_engines.alo	Missing	['btl_k-wing.alo']
pte_imperial-class_engines_large.alo	Missing	['dominator_i-class_star_destroyer.alo', 'imperial_i-class_star_destroyer.alo', 'imperial_ii-class_star_destroyer.alo', 'imperial_ii-class_star_destroyer_black.alo']
pte_imperial-class_engines_small.alo	Missing	['dominator_i-class_star_destroyer.alo', 'imperial_i-class_star_destroyer.alo', 'imperial_ii-class_star_destroyer.alo', 'imperial_ii-class_star_destroyer_black.alo']
p_hp_archammer-damage.alo	Missing	['ev_archammer.alo']
hp_engines_emitdamage.alo	Missing	['ev_demolisher.alo']
hp01_emitdamage.alo	Missing	['ev_demolisher.alo']
hp02_emitdamage.alo	Missing	['ev_demolisher.alo']
hp03_emitdamage.alo	Missing	['ev_demolisher.alo']
hp04_emitdamage.alo	Missing	['ev_demolisher.alo']
spawn_00_emitdamage.alo	Missing	['ev_demolisher.alo']
hp05_emitdamage.alo	Missing	['ev_demolisher.alo']
shieldgen_emitdamage.alo	Missing	['ev_demolisher.alo']
camera01.alo	Missing	['ev_demolisher_d.alo']
pe_tieengines.alo	Missing	['ev_tieavenger.alo']
p_blank_blank.alo	Missing	['ev_victory1.alo', 'ev_victory2.alo']
p_blank_blank__.alo	Missing	['ev_victory1.alo', 'ev_victory2.alo']
a_lichtexplo_test.alo	Missing	['ev_victory2_death.alo']
p_hp_alliancex4.alo	Missing	['ffh_rv_kdy_endurance.alo']
p_hp_alliancex2.alo	Missing	['ffh_rv_kdy_endurance.alo', 'ffh_rv_new_nebula_defendersd.alo']
p_hp_alliancex3.alo	Missing	['ffh_rv_kdy_endurance.alo', 'ffh_rv_new_nebula_defendersd.alo']
pptw_ptwsa4.alo	Missing	['ffh_rv_kdy_endurance.alo', 'ffh_rv_new_nebula_defendersd.alo']
pte_nebulafalse.alo	Missing	['ffh_rv_kdy_endurance.alo', 'ffh_rv_new_nebula_defendersd.alo']
pte_victory2.alo	Missing	['ffh_rv_kdy_endurance.alo', 'ffh_rv_new_nebula_defendersd.alo']
pe_allegianceclass.alo	Missing	['f_allegiance.alo']
pe_assaultcruise.alo	Missing	['f_assault.alo']
pe_bothan_assault_eng.alo	Missing	['f_bothan.alo']
pe_assassinengines.alo	Missing	['f_corellian_gunship.alo']
pe_dauntless_engin.alo	Missing	['f_dauntless.alo']
pe_dreadnought00.alo	Missing	['f_dreadnought.alo']
pe_warrior_engines.alo	Missing	['f_ferret.alo']
pte_warrior_engines.alo	Missing	['f_ferret.alo']
pe_tiescoutenging.alo	Missing	['f_gunboat.alo']
pe_mc80ho_cruiser_.alo	Missing	['f_independence.alo']
pe_liberator_cruiser_eng.alo	Missing	['f_liberator.alo']
pe_majestic_engine.alo	Missing	['f_majestic.alo']
pe_mc40_cruiser_en.alo	Missing	['f_mc40b.alo']
pe_mc80_cruiser_en.alo	Missing	['f_mc80b.alo']
pe_mc80b_cruiser__.alo	Missing	['f_mc80c.alo']
pe_mc90_cruiser_en.alo	Missing	['f_mc90.alo']
pe_sacheen_engines.alo	Missing	['f_sacheen.alo']
pte_sacheen_engines.alo	Missing	['f_sacheen.alo']
p_ssd_chain00.alo	Missing	['galaxy_destroyer_d.alo', 'strident_d.alo', 'viscount_d.alo']
pte_marauder-class_engine.alo	Missing	['marauder-class_corvette.alo']
pe_modular_taskforce_engines.alo	Missing	['modular_taskforce_cruiser.alo']
pi_damage_elec_capital.alo	Missing	['reef_home-class_mc80_star_cruiser.alo', 'tector_i-class_star_destroyer.alo']
pe_reef_home-class_engines_large.alo	Missing	['reef_home-class_mc80_star_cruiser.alo']
pe_reef_home-class_engines_medium.alo	Missing	['reef_home-class_mc80_star_cruiser.alo']
pe_reef_home-class_engines_small.alo	Missing	['reef_home-class_mc80_star_cruiser.alo']
pet_rep_corvette.alo	Missing	['rep_corvette_03.alo']
p_blank_blan.alo	Missing	['rev_acclamator1.alo']
p_clone_jetpack.alo	Missing	['ri_antitrooper_dc15a.alo']
pe_ranger__gunship.alo	Missing	['rv_ranger.alo']
p_explosion_huge01x.alo	Missing	['rv_ranger_d.alo']
pte_z95enginesland.alo	Missing	['rv_ulav.alo']
pe_z95enginesland.alo	Missing	['rv_ulav.alo']
pe_speedengines.alo	Missing	['rv_vwing.alo']
pte_speedengines.alo	Missing	['rv_vwing.alo']
pe_cis_carrier_l.alo	Missing	['sev_carrier.alo']
pe_cis_carrier_s.alo	Missing	['sev_carrier.alo']
p_fire_lrg_00.alo	Missing	['sev_carrier.alo']
pte_t-65_x-wing_engines.alo	Missing	['t-65_x-wing_starfighter.alo']
pe_venator-class_engines_small.alo	Missing	['venator-class_star_destroyer.alo', 'venator-class_star_destroyer_republic.alo']
pe_venator-class_engines_large.alo	Missing	['venator-class_star_destroyer.alo', 'venator-class_star_destroyer_republic.alo']
pe_venator-class_engines_medium.alo	Missing	['venator-class_star_destroyer.alo', 'venator-class_star_destroyer_republic.alo']
all_arch_imp_crawler_normal.dds	Unused	[]
all_arch_imp_kass_city_bench_diffuse.dds	Unused	[]
all_arch_imp_kass_city_bench_normal.dds	Unused	[]
all_item_corellia_large_sign_01_normal.dds	Unused	[]
all_item_rep_barricade_metal_normal.dds	Unused	[]
bluethruster_b.dds	Unused	[]
cis_crabdroid.dds	Unused	[]
cis_crabdroid_b.dds	Unused	[]
cis_droid_gunship_bump.dds	Unused	[]
cis_droid_gunship_diff.dds	Unused	[]
cis_homing_droid_bump.dds	Unused	[]
cis_homing_droid_diff.dds	Unused	[]
cis_mtt_bluestripes.dds	Unused	[]
cis_planetary_gun.dds	Unused	[]
cis_planetary_gun_normal.dds	Unused	[]
cis_snailtank_eyes.dds	Unused	[]
cis_snail_tank_parts.dds	Unused	[]
cis_snail_tank_parts2.dds	Unused	[]
cis_snail_tank_parts2_n.dds	Unused	[]
cis_snail_tank_parts_n.dds	Unused	[]
cis_snail_tank_tread.dds	Unused	[]
cis_snail_tank_tread2.dds	Unused	[]
cis_snail_tank_tread2_n.dds	Unused	[]
cis_snail_tank_tread_n.dds	Unused	[]
cis_tank_fighter_1.dds	Unused	[]
cis_tank_fighter_1_b.dds	Unused	[]
cis_tank_fighter_2.dds	Unused	[]
cis_tank_fighter_2_b.dds	Unused	[]
cis_tank_fighter_3.dds	Unused	[]
cis_tank_fighter_3_b.dds	Unused	[]
cis_tank_fighter_4.dds	Unused	[]
cis_tank_fighter_4_b.dds	Unused	[]
conqueror_star_destroyer.dds	Unused	[]
conqueror_star_destroyer_bridge.dds	Unused	[]
conqueror_star_destroyer_bridge_normal.dds	Unused	[]
conqueror_star_destroyer_normal.dds	Unused	[]
corellian_bb.dds	Unused	[]
crl_arch_city_road_diffuse.dds	Unused	[]
crl_arch_city_road_normal.dds	Unused	[]
crl_arch_city_road_walkway_02_diffuse.dds	Unused	[]
crl_arch_city_road_walkway_02_normal.dds	Unused	[]
cv_invisible_hand.dds	Unused	[]
cv_munificent_tonith.dds	Unused	[]
dreadnaught_b.dds	Unused	[]
ei_army_engineer_body.dds	Unused	[]
ei_army_engineer_helmet.dds	Unused	[]
ei_darktrooper_pack.dds	Unused	[]
ei_elite_guard_body.dds	Unused	[]
ei_elite_guard_helmet.dds	Unused	[]
ei_elite_guard_legs.dds	Unused	[]
ei_gadmiral_thrawn.dds	Unused	[]
ei_gadmiral_thrawn_bc.dds	Unused	[]
ei_imperialcolonel.dds	Unused	[]
ei_isb_colon.dds	Unused	[]
ei_isb_private.dds	Unused	[]
ei_isb_sergant.dds	Unused	[]
ei_isb_trooper.dds	Unused	[]
ei_novatrooper_helmet.dds	Unused	[]
ei_novatrooper_legs.dds	Unused	[]
ei_officer_body.dds	Unused	[]
ei_officer_body_b.dds	Unused	[]
ei_officer_gloves.dds	Unused	[]
ei_officer_gloves_b.dds	Unused	[]
ei_stormcommando.dds	Unused	[]
ei_stormcommando_b.dds	Unused	[]
ei_stormcommando_glov.dds	Unused	[]
ei_stormcommando_glov_b.dds	Unused	[]
ei_stormcommando_helm.dds	Unused	[]
ei_stormcommando_helm_b.dds	Unused	[]
ei_stormtrooper.dds	Unused	[]
ei_stormtrooper_b.dds	Unused	[]
ei_stormtrooper_glov.dds	Unused	[]
ei_stormtrooper_glov_b.dds	Unused	[]
ei_stormtrooper_helm.dds	Unused	[]
ei_stormtrooper_helm_b.dds	Unused	[]
ei_stormtrooper_pauldron.dds	Unused	[]
engine_glow_fancy_white.tga	Unused	[]
escort_carrier.dds	Unused	[]
es_imperial_i_class_star_destroyer.dds	Unused	[]
es_imperial_i_class_star_destroyer_l.dds	Unused	[]
es_imperial_i_class_star_destroyer_n.dds	Unused	[]
ev_a9_floating_fortress_dozer.dds	Unused	[]
ev_a9_floating_fortress_dozer_b.dds	Unused	[]
ev_assertor_ssd1.dds	Unused	[]
ev_assertor_ssd1_b.dds	Unused	[]
ev_assertor_ssd2.dds	Unused	[]
ev_assertor_ssd2_b.dds	Unused	[]
ev_assertor_ssd3.dds	Unused	[]
ev_assertor_ssd3_b.dds	Unused	[]
ev_at-st-as.dds	Unused	[]
ev_at-st-as_bc.dds	Unused	[]
ev_atdp.dds	Unused	[]
ev_atdp_n.dds	Unused	[]
ev_atpt cilind_b.dds	Unused	[]
ev_atpt_body1.dds	Unused	[]
ev_atpt_body1_b.dds	Unused	[]
ev_atpt_cilind.dds	Unused	[]
ev_atpt_cockpit.dds	Unused	[]
ev_atpt_cockpit_b.dds	Unused	[]
ev_atpt_extras.dds	Unused	[]
ev_atpt_extras_b.dds	Unused	[]
ev_atpt_foot.dds	Unused	[]
ev_atpt_foot_b.dds	Unused	[]
ev_atpt_head.dds	Unused	[]
ev_atpt_head_b.dds	Unused	[]
ev_atpt_legs.dds	Unused	[]
ev_atpt_legs2.dds	Unused	[]
ev_atpt_legs2_b.dds	Unused	[]
ev_atpt_legs_b.dds	Unused	[]
ev_atpt_subhead.dds	Unused	[]
ev_atpt_subhead_b.dds	Unused	[]
ev_bellator.dds	Unused	[]
ev_bellator_b.dds	Unused	[]
ev_executor_blocks.dds	Unused	[]
ev_executor_blocks_b.dds	Unused	[]
ev_executor_extras.dds	Unused	[]
ev_executor_extras_b.dds	Unused	[]
ev_executor_plates.dds	Unused	[]
ev_executor_plates_b.dds	Unused	[]
ev_executor_plates_re.dds	Unused	[]
ev_executor_plates_re_b.dds	Unused	[]
ev_idt_1.dds	Unused	[]
ev_idt_1n.dds	Unused	[]
ev_idt_2.dds	Unused	[]
ev_idt_2n.dds	Unused	[]
ev_idt_3.dds	Unused	[]
ev_idt_3n.dds	Unused	[]
ev_s1_firehawke.dds	Unused	[]
ev_s1_firehawke_bump.dds	Unused	[]
ev_scanlines5.dds	Unused	[]
ev_secutor.dds	Unused	[]
ev_secutor_b.dds	Unused	[]
ev_warhammerr22-25.dds	Unused	[]
ev_warhammerr22-25lights.dds	Unused	[]
ev_warhammerr26.dds	Unused	[]
ev_warhammerr26lights.dds	Unused	[]
ev_warhammerr27.dds	Unused	[]
ev_warhammerr27lights.dds	Unused	[]
ev_warhammerr28.dds	Unused	[]
ev_warhammerr28lights.dds	Unused	[]
ev_warhammerr29-30.dds	Unused	[]
ev_warhammerr29-30lights.dds	Unused	[]
ev_warhammerr31-32.dds	Unused	[]
ev_warhammerr31-32lights.dds	Unused	[]
ev_warhammerr34.dds	Unused	[]
ev_warhammerr39.dds	Unused	[]
ev_warhammerr39lights.dds	Unused	[]
ew_rt_97c.dds	Unused	[]
ew_rt_97c_b.dds	Unused	[]
exshckwave.dds	Unused	[]
eye_blue.dds	Unused	[]
eye_n.dds	Unused	[]
head_eli.dds	Unused	[]
head_eli_b.dds	Unused	[]
head_romodi.dds	Unused	[]
head_romodi_b.dds	Unused	[]
imp_eidolon.dds	Unused	[]
imp_heavy_corvette.dds	Unused	[]
imp_praetorbattlercruiser_c.dds	Unused	[]
imp_praetorbattlercruiser_n.dds	Unused	[]
imp_s1_firehawke_n.dds	Unused	[]
imp_snowtrooper.dds	Unused	[]
imp_snowtrooper_backpack.dds	Unused	[]
imp_snowtrooper_backpack_n.dds	Unused	[]
imp_snowtrooper_cape.dds	Unused	[]
imp_snowtrooper_cape_n.dds	Unused	[]
imp_snowtrooper_hands.dds	Unused	[]
imp_snowtrooper_hands_n.dds	Unused	[]
imp_snowtrooper_helmet.dds	Unused	[]
imp_snowtrooper_helmet_n.dds	Unused	[]
imp_snowtrooper_n.dds	Unused	[]
imp_stormcommando.dds	Unused	[]
imp_stormcommando_hands.dds	Unused	[]
imp_stormcommando_hands_n.dds	Unused	[]
imp_stormcommando_helmet.dds	Unused	[]
imp_stormcommando_helmet_n.dds	Unused	[]
imp_stormcommando_n.dds	Unused	[]
imp_stormtrooper_backpack.dds	Unused	[]
imp_stormtrooper_snow.dds	Unused	[]
imp_stormtrooper_snow_n.dds	Unused	[]
imp_tie_cockpit.dds	Unused	[]
i_circle02.dds	Unused	[]
i_selection_space.dds	Unused	[]
liberty-class_mc80_star_cruiser.dds	Unused	[]
liberty-class_mc80_star_cruiser_normal.dds	Unused	[]
light.dds	Unused	[]
mc-60.dds	Unused	[]
mc80c.dds	Unused	[]
mc_40.dds	Unused	[]
mc_80.dds	Unused	[]
mt_commandbar.mtd	Unused	[]
nar_arch_city_facade_addon_metal_02_diffuse.dds	Unused	[]
nar_arch_city_facade_addon_metal_02_normal.dds	Unused	[]
nar_arch_city_facade_addon_trim_diffuse.dds	Unused	[]
nar_arch_city_facade_addon_trim_normal.dds	Unused	[]
neu_cockpit.dds	Unused	[]
planetgas0-cl.dds	Unused	[]
p_black_hole_gravity.tga	Unused	[]
p_fire.tga	Unused	[]
p_hardcell_debris_1.dds	Unused	[]
p_hardcell_debris_1n.dds	Unused	[]
p_hardcell_debris_2.dds	Unused	[]
p_hardcell_debris_2n.dds	Unused	[]
p_hardcell_debris_3.dds	Unused	[]
p_hardcell_debris_3n.dds	Unused	[]
p_hardcell_debris_4.dds	Unused	[]
p_hardcell_debris_4n.dds	Unused	[]
p_hardcell_debris_5.dds	Unused	[]
p_hardcell_debris_5n.dds	Unused	[]
p_particle_exp1_orig.dds	Unused	[]
p_particle_light.dds	Unused	[]
p_particle_lord.dds	Unused	[]
p_particle_lord_map.jpg	Unused	[]
p_particle_lord_normal.dds	Unused	[]
rc_sniperrifle.dds	Unused	[]
reactor_lens_effect_shine_white.dds	Unused	[]
reb_defender_destroye2.dds	Unused	[]
reb_defender_destroyer.dds	Unused	[]
reb_defender_destroyer_b.dds	Unused	[]
reb_freerunner.dds	Unused	[]
reb_freerunner_n.dds	Unused	[]
reb_guerilla.dds	Unused	[]
reb_guerilla_helmet.dds	Unused	[]
reb_guerilla_helmet_n.dds	Unused	[]
reb_guerilla_n.dds	Unused	[]
reb_pathfinder.dds	Unused	[]
reb_pathfinder_head.dds	Unused	[]
reb_pathfinder_head_n.dds	Unused	[]
reb_pathfinder_helmet.dds	Unused	[]
reb_pathfinder_helmet_n.dds	Unused	[]
reb_pathfinder_n.dds	Unused	[]
reb_royal_guard.dds	Unused	[]
reb_royal_guard_helmet.dds	Unused	[]
reb_royal_guard_helmet_n.dds	Unused	[]
reb_royal_guard_n.dds	Unused	[]
reb_t47_snowspeeder.dds	Unused	[]
reb_t47_snowspeeder_n.dds	Unused	[]
reb_trooper.dds	Unused	[]
reb_trooper_helmet.dds	Unused	[]
reb_trooper_helmet_n.dds	Unused	[]
reb_trooper_n.dds	Unused	[]
reb_trooper_strap.dds	Unused	[]
reb_trooper_strap_n.dds	Unused	[]
reb_t_2b.dds	Unused	[]
reb_t_2b_n.dds	Unused	[]
reb_vanguard_parts.dds	Unused	[]
reb_vanguard_parts_n.dds	Unused	[]
redflash.dds	Unused	[]
rep_dc15rifle.dds	Unused	[]
rep_dc15rifle_b.dds	Unused	[]
rep_hover_fightertank.dds	Unused	[]
rep_hover_fightertank_b.dds	Unused	[]
rhn_bldg_bridge.dds	Unused	[]
rhn_ruin_stairs.dds	Unused	[]
ri_kyle_katarn_jedi.dds	Unused	[]
ri_new_republic_marine.dds	Unused	[]
ri_new_republic_marine_n.dds	Unused	[]
rv_aac_hovertank bump.dds	Unused	[]
rv_endurance.dds	Unused	[]
rv_enduranceengines.dds	Unused	[]
rv_enduranceengines_bc.dds	Unused	[]
rv_endurance_bc.dds	Unused	[]
rv_nebulachassis_bc.dds	Unused	[]
rv_nebulachassis_tc.dds	Unused	[]
rv_nebulaengine.dds	Unused	[]
rv_nebulaengine_bc.dds	Unused	[]
sei_battledroid.dds	Unused	[]
sei_e5.dds	Unused	[]
sev_bulwark.dds	Unused	[]
stormtrooper_body.dds	Unused	[]
stormtrooper_body_b.dds	Unused	[]
stormtrooper_e11.dds	Unused	[]
stormtrooper_e11_b.dds	Unused	[]
stormtrooper_hands.dds	Unused	[]
stormtrooper_hands_b.dds	Unused	[]
stormtrooper_helmet.dds	Unused	[]
stormtrooper_helmet_b.dds	Unused	[]
stormtrooper_magma_backpack.dds	Unused	[]
stormtrooper_magma_backpack_b.dds	Unused	[]
tyt_speedtree_shrub_diffuse.dds	Unused	[]
tyt_speedtree_shrub_normal.dds	Unused	[]
tyt_speedtree_thicket_diffuse.dds	Unused	[]
tyt_speedtree_thicket_normal.dds	Unused	[]
util_collision_hidden_d.dds	Unused	[]
weap_minimag.dds	Unused	[]
weap_minimag_n.dds	Unused	[]
weap_rt_97c_blaster.dds	Unused	[]
weap_rt_97c_blaster_b.dds	Unused	[]
weap_tl_50_blaster.dds	Unused	[]
weap_tl_50_blaster_b.dds	Unused	[]
weap_t_21_blaster.dds	Unused	[]
weap_t_21_blaster_b.dds	Unused	[]
windows normal.dds	Unused	[]
w_bespin_buildings.dds	Unused	[]
w_bespin_buildings_b.dds	Unused	[]
w_black_hole_3.dds	Unused	[]
w_blank_skin.dds	Unused	[]
w_blaster.dds	Unused	[]
w_byss_citadel.dds	Unused	[]
w_byss_citadel_l.dds	Unused	[]
w_byss_citadel_n.dds	Unused	[]
w_clouds_telos.dds	Unused	[]
w_crl_arch_city_dirt_d.dds	Unused	[]
w_crl_arch_city_foundation_addon_metal01_b.dds	Unused	[]
w_crl_arch_city_foundation_addon_metal01_d.dds	Unused	[]
w_crl_arch_city_foundation_addon_rubble_b.dds	Unused	[]
w_crl_arch_city_foundation_addon_rubble_d.dds	Unused	[]
w_crl_arch_city_grass_02_d.dds	Unused	[]
w_crl_arch_city_grass_b.dds	Unused	[]
w_crl_arch_city_grass_d.dds	Unused	[]
w_crl_arch_city_marble_d.dds	Unused	[]
w_crl_arch_city_road_walkway_02_b.dds	Unused	[]
w_crl_arch_city_road_walkway_02_d.dds	Unused	[]
w_crl_arch_city_road_walkway_03_b.dds	Unused	[]
w_crl_arch_city_road_walkway_03_d.dds	Unused	[]
w_crl_arch_city_road_walkway_d.dds	Unused	[]
w_genericlights_tile.dds	Unused	[]
w_ion_dmg.dds	Unused	[]
w_laser.dds	Unused	[]
w_laser_rebel.dds	Unused	[]
w_laser_red.dds	Unused	[]
w_laser_smabl.dds	Unused	[]
w_lightcircle.dds	Unused	[]
w_nebula_wrap_t.dds	Unused	[]
w_nemsmoke_dark.dds	Unused	[]
w_planetclouds_custom2.dds	Unused	[]
w_planetclouds_pin.dds	Unused	[]
w_planet_atmosphere_green.tga	Unused	[]
w_planet_atmosphere_purple.tga	Unused	[]
w_planet_atmosphere_red.tga	Unused	[]
w_planet_atmosphere_yellow.tga	Unused	[]
w_plx_2m.dds	Unused	[]
w_plx_2m_n.dds	Unused	[]
w_pts.dds	Unused	[]
w_raxus_junk.dds	Unused	[]
w_raxus_junk_bc.dds	Unused	[]
w_rudrig_grass00.dds	Unused	[]
w_rudrig_grass03.dds	Unused	[]
w_rudrig_grassrock00.dds	Unused	[]
w_rudrig_grassrock01.dds	Unused	[]
w_rudrig_grassrock02.dds	Unused	[]
w_sky_bespin1.dds	Unused	[]
w_sky_bespin2.dds	Unused	[]
w_sky_bespin3.dds	Unused	[]
w_sparkle1.tga	Unused	[]
w_sparkle_dim.dds	Unused	[]
w_stars_outer_rim.dds	Unused	[]
px-10_compact_assault_vehicle_treads.dds	Missing	['century_tank.alo']
px-10_compact_assault_vehicle_treads_normal.dds	Missing	['century_tank.alo']
hangar.dds	Missing	['ev_13x.alo', 'ev_victory_lp.alo']
w_laser_smallxr.dds	Missing	['ev_at_dp.alo']
rv_quasarcarrier.dds	Missing	['ffh_rv_kdy_endurance.alo']
rv_quasarcarrier_b.dds	Missing	['ffh_rv_kdy_endurance.alo']
b-wing.dds	Missing	['f_gunboat.alo', 'f_missile_gunboat.alo', 'sev_tridroid.alo']
mc75.dds	Missing	['f_majestic.alo']
ef_nebulon-b_escort_frigate_thruster_off.dds	Missing	['r-41_starchaser.alo']
ef_nebulon-b_escort_frigate_thruster_off_normal.dds	Missing	['r-41_starchaser.alo']
ef_nebulon-b_escort_frigate_thruster_on.dds	Missing	['r-41_starchaser.alo']
reb_t2b.dds	Missing	['reb_t2b.alo']
reb_t2b_n.dds	Missing	['reb_t2b.alo']
ri_jacensolo.dds	Missing	['ri_corran_horn.alo']
mediator_engines.dds	Missing	['rv_mediator_cruiser_d.alo']
mediator_engines_gloss.dds	Missing	['rv_mediator_cruiser_d.alo']
rv_t2b_c.dds	Missing	['rv_t2_b.alo', 'rv_t2_b_00.alo']
rv_t2b_n.dds	Missing	['rv_t2_b.alo', 'rv_t2_b_00.alo']
demo_attract_kamino.dds	Missing	['demo_attract_kamino.ted']
test_map1.dds	Missing	['test_map1.ted']
test_map2.dds	Missing	['test_map2.ted']
test_map3.dds	Missing	['test_map3.ted']
test_map4.dds	Missing	['test_map4.ted']
test_map7.dds	Missing	['test_map7.ted']
test_map8.dds	Missing	['test_map8.ted']
_land_planet_balmorra_00.dds	Missing	['_land_planet_balmorra_00.ted']
_land_planet_celanon_00.dds	Missing	['_land_planet_celanon_00.ted']
_land_planet_denon_00.dds	Missing	['_land_planet_denon_00.ted']
_land_planet_druckenwell_00.dds	Missing	['_land_planet_druckenwell_00.ted']
w_bespin_tiles_00	Missing	['_land_planet_lianna_00.ted']
w_bespin_tiles_00_bc	Missing	['_land_planet_lianna_00.ted']
_land_planet_nar_shaddaa_00.dds	Missing	['_land_planet_nar_shaddaa_00.ted']
_land_planet_ralltiir_00.dds	Missing	['_land_planet_ralltiir_00.ted']
_land_planet_telos_00.dds	Missing	['_land_planet_telos_00.ted']
_land_planet_terminus_01.dds	Missing	['_land_planet_terminus_01.ted']
_land_planet_vulpter_00.dds	Missing	['_land_planet_vulpter_00.ted']
