ev_bike.alo	Cin_groundinfantry.xml Groundcompaniesempire.xml Groundinfantry.xml 
ei_trooper.alo	Cin_groundinfantry.xml Genericherounits.xml Groundcompaniesempire.xml Groundinfantry.xml 
ri_infantry_dummy.alo	Cin_groundinfantry.xml 
ri_infantry_dummy2.alo	Cin_groundinfantry.xml 
ui_droideka_dummy.alo	Cin_groundinfantry.xml 
ui_droideka_dummy2.alo	Cin_groundinfantry.xml 
cin_rv_xwingprop.alo	Cin_groundprops.xml Groundstructures.xml 
eb_basewall-mid_dest.alo	Cin_groundprops.xml Groundstructures.xml 
cin_deathstar_hangar.alo	Cin_groundprops.xml 
w_sith_lefthall.alo	Cin_groundprops.xml 
w_carbonite_sith_master.alo	Cin_groundprops.xml 
w_cave_door.alo	Cin_groundprops.xml 
w_sith_door.alo	Cin_groundprops.xml 
w_sith_righthall.alo	Cin_groundprops.xml 
w_wall_arch.alo	Cin_groundprops.xml 
w_sith_roof.alo	Cin_groundprops.xml 
w_sith_console.alo	Cin_groundprops.xml 
w_tile.alo	Cin_groundprops.xml 
w_cin_sith_statue.alo	Cin_groundprops.xml 
w_sith_arch.alo	Cin_groundprops.xml 
w_sith_column.alo	Cin_groundprops.xml 
w_carbonite_sith.alo	Cin_groundprops.xml 
cin_trooper_row.alo	Cin_groundprops.xml 
cin_biker_row.alo	Cin_groundprops.xml 
cin_officer_row.alo	Cin_groundprops.xml 
cin_navytrooper_row.alo	Cin_groundprops.xml 
cin_lambda_mouth.alo	Cin_groundprops.xml 
cin_lambda_head.alo	Cin_groundprops.xml 
cin_reb_celebhall.alo	Cin_groundprops.xml 
cin_reb_celebcharacters.alo	Cin_groundprops.xml 
cin_rbel_navyrow.alo	Cin_groundprops.xml 
cin_rbel_soldier.alo	Cin_groundprops.xml 
cin_rbel_soldier_group.alo	Cin_groundprops.xml 
cin_rbel_grey.alo	Cin_groundprops.xml 
cin_rbel_greygroup.alo	Cin_groundprops.xml 
cin_ev_lambdashuttle_150.alo	Cin_groundprops.xml 
cin_ei_vader.alo	Cin_groundprops.xml 
cin_ei_palpatine.alo	Cin_groundprops.xml 
ri_plexs_forest.alo	Cin_groundprops.xml Groundinfantry.xml 
ri_infantry_forest.alo	Cin_groundprops.xml Groundinfantry.xml 
cin_fire_huge.alo	Cin_groundprops.xml 
cin_fire_medium.alo	Cin_groundprops.xml 
cin_probe_droid.alo	Cin_groundprops.xml 
rv_transport.alo	Cin_groundvehicles.xml Groundstructures.xml Groundvehicles.xml Transportunits.xml 
cine_ev_stardestroyer_hp00_l-f.alo	Cin_hardpoints.xml 
cine_ev_stardestroyer_hp00_f-r.alo	Cin_hardpoints.xml 
cine_ev_stardestroyer_hp00_b-l.alo	Cin_hardpoints.xml 
cine_ev_stardestroyer_hp00_b-r.alo	Cin_hardpoints.xml 
cine_ev_stardestroyer_hp00_m-l.alo	Cin_hardpoints.xml 
cine_ev_stardestroyer_hp00_m-r.alo	Cin_hardpoints.xml 
ev_stardestroyer_hp00_m-c.alo	Cin_hardpoints.xml Hardpoints.xml Spaceprops.xml 
cin_p_proton_torpedo.alo	Cin_projectiles.xml 
w_planet_tatooine_high.alo	Cin_spaceprops.xml Spaceprops.xml 
cin_coruscant.alo	Cin_spaceprops.xml 
cin_planet_alderaan_high.alo	Cin_spaceprops.xml 
cin_planet_hoth_high.alo	Cin_spaceprops.xml 
cin_ev_stardestroyer_warp.alo	Cin_spaceprops.xml 
cin_bridge.alo	Cin_spaceprops.xml Props_story.xml 
ei_vader.alo	Cin_spaceprops.xml Namedherounits.xml 
cin_officer.alo	Cin_spaceprops.xml 
cin_deathstar_high.alo	Cin_spaceprops.xml Props_story.xml 
w_planet_hoth_high.alo	Cin_spaceprops.xml Spaceprops.xml 
cin_dstar_dish_close.alo	Cin_spaceprops.xml 
cin_dstar_leverpanel.alo	Cin_spaceprops.xml 
cin_deathstar_wall.alo	Cin_spaceprops.xml 
rv_xwing.alo	Cin_spaceprops.xml Spaceunitsfighters.xml Squadrons.xml Uniqueunits.xml Units_hero_rebel_lukeskywalker.xml 
cin_dstar_protons.alo	Cin_spaceprops.xml 
cin_dstar_turretlasers.alo	Cin_spaceprops.xml 
cin_ev_tieadvanced.alo	Cin_spaceprops.xml 
cin_imperialcraft.alo	Cin_spaceprops.xml 
cin_shuttle_tyderium.alo	Cin_spaceprops.xml 
rv_moncalcruiser.alo	Cin_spaceunitscapital.xml Spaceunitscapital.xml 
rv_moncalcruiser_d.alo	Cin_spaceunitscapital.xml Spaceunitscapital.xml 
rv_moncalcruiser_hulk.alo	Cin_spaceunitscapital.xml Spaceprops.xml 
ev_stardestroyer.alo	Cin_spaceunitscapital.xml Spaceunitscapital.xml 
ev_stardestroyer_hulk.alo	Cin_spaceunitscapital.xml Spaceunitscapital.xml 
ev_stardestroyer_d.alo	Cin_spaceunitscapital.xml Spaceunitscapital.xml Uniqueunits.xml 
ev_stardestroyer_dead.alo	Cin_spaceunitscapital.xml Spaceunitscapital.xml Uniqueunits.xml Units_hero_empire_thrawn.xml 
cine_ev_stardestroyer.alo	Cin_spaceunitscapital.xml 
i_galactic_controls.alo	Commandbarcomponents.xml 
i_galactic_organize.alo	Commandbarcomponents.xml 
i_tactical_controls.alo	Commandbarcomponents.xml 
i_deathstar_switch.alo	Commandbarcomponents.xml 
i_build_buttons.alo	Commandbarcomponents.xml 
i_main_reinforce.alo	Commandbarcomponents.xml 
i_attack_mode_choice.alo	Commandbarcomponents.xml 
i_resolve_mode.alo	Commandbarcomponents.xml 
i_neutralize_hero.alo	Commandbarcomponents.xml 
i_main_hero_frame_rebel.alo	Commandbarcomponents.xml 
i_main_hero_frame_empire.alo	Commandbarcomponents.xml 
i_attack_mode.alo	Commandbarcomponents.xml 
i_attack_mode_single.alo	Commandbarcomponents.xml 
planetary_mode.alo	Commandbarcomponents.xml 
planetary_mode_overlay.alo	Commandbarcomponents.xml 
i_black_market.alo	Commandbarcomponents.xml 
i_sabotage.alo	Commandbarcomponents.xml 
i_corrupt_choice.alo	Commandbarcomponents.xml 
i_hack.alo	Commandbarcomponents.xml 
w_planet_fleet.alo	Containers.xml 
rv_ywing.alo	Containers.xml Groundvehicles.xml Landbombingrununits.xml Spaceunitsfighters.xml Squadrons.xml 
ni_bothan.alo	Corruption_special_units.xml Groundindigenous.xml 
ri_infantry.alo	Corruption_special_units.xml Genericherounits.xml Groundcompaniesrebel.xml Groundindigenous.xml Groundinfantry.xml Props_story.xml 
ni_geonosian.alo	Corruption_special_units.xml Groundindigenous.xml 
ri_wookiee01.alo	Corruption_special_units.xml Groundindigenous.xml Props_story.xml 
ni_gungan.alo	Corruption_special_units.xml Groundindigenous.xml 
ni_gmale_urban_a.alo	Corruption_special_units.xml Groundindigenous.xml Groundinfantry.xml 
ni_gmale_snow.alo	Corruption_special_units.xml Groundindigenous.xml 
ni_twilek_f.alo	Corruption_special_units.xml Groundindigenous.xml Hutt_faction_units.xml 
ni_sullustan.alo	Corruption_special_units.xml Groundindigenous.xml 
ni_moncalciv.alo	Corruption_special_units.xml Groundindigenous.xml 
w_waypoint_beacon.alo	Gameconstants.xml 
ri_fieldcommander.alo	Genericherounits.xml 
ei_fieldcommander.alo	Genericherounits.xml Props_story.xml 
rb_acc_l01.alo	Groundbases.xml 
rb_acc_l02.alo	Groundbases.xml 
rb_acc_l03.alo	Groundbases.xml 
rb_acc_l04.alo	Groundbases.xml 
rb_acc_l05.alo	Groundbases.xml 
nb_basepad_imperial.alo	Groundbuildablesempire.xml 
nb_repairfacility.alo	Groundbuildablesempire.xml Groundbuildableshutts.xml Groundbuildablespirate.xml Groundbuildablesrebel.xml Groundbuildablesunderworld.xml Groundturrets.xml 
nb_bactatank.alo	Groundbuildablesempire.xml Groundbuildableshutts.xml Groundbuildablespirate.xml Groundbuildablesrebel.xml Groundbuildablesunderworld.xml Groundturrets.xml 
eb_aaturret.alo	Groundbuildablesempire.xml Groundturrets.xml Props_story.xml 
eb_infantryturret.alo	Groundbuildablesempire.xml Groundturrets.xml 
eb_vehicleturret.alo	Groundbuildablesempire.xml Groundturrets.xml 
nb_sensornode.alo	Groundbuildablesempire.xml Groundbuildableshutts.xml Groundbuildablesrebel.xml Groundbuildablesunderworld.xml Groundstructures.xml 
nb_basepad.alo	Groundbuildableshutts.xml Groundbuildablespirate.xml Groundbuildablesskirmish.xml Multiplayer_structure_markers.xml 
rb_aa-turret.alo	Groundbuildableshutts.xml Groundbuildablespirate.xml Groundbuildablesrebel.xml Groundturrets.xml 
rb_turret.alo	Groundbuildablespirate.xml Groundbuildablesrebel.xml Groundturrets.xml 
rb_vehicleturret.alo	Groundbuildablespirate.xml Groundbuildablesrebel.xml Groundturrets.xml 
nb_basepad_rebel.alo	Groundbuildablesrebel.xml 
rb_shield-generator.alo	Groundbuildablesskirmish.xml Hutt_faction_units.xml Markers.xml Multiplayer_structure_markers.xml Specialstructures.xml 
nb_baseshieldgen.alo	Groundbuildablesskirmish.xml Hutt_faction_units.xml Markers.xml Multiplayer_structure_markers.xml Specialstructures.xml 
nb_baseshieldgen_small.alo	Groundbuildablesskirmish.xml Markers.xml Multiplayer_structure_markers.xml Specialstructures.xml 
nb_cmc22mining.alo	Groundbuildablesskirmish.xml Specialstructures.xml Specialstructures_underworld.xml 
eb_tltower.alo	Groundbuildablesskirmish.xml Markers.xml Multiplayer_structure_markers.xml Secondarystructures.xml Specialstructures.xml 
eb_infantrybarracks.alo	Groundbuildablesskirmish.xml Specialstructures.xml 
rb_infantrybarracks.alo	Groundbuildablesskirmish.xml Multiplayer_structure_markers.xml Specialstructures.xml 
eb_lightfactory.alo	Groundbuildablesskirmish.xml Specialstructures.xml 
rb_lightvehiclefactory.alo	Groundbuildablesskirmish.xml Multiplayer_structure_markers.xml Specialstructures.xml 
eb_vehiclefactory.alo	Groundbuildablesskirmish.xml Markers.xml Secondarystructures.xml Specialstructures.xml 
rb_heavyvehiclefactory.alo	Groundbuildablesskirmish.xml Markers.xml Multiplayer_structure_markers.xml Secondarystructures.xml Specialstructures.xml 
eb_megaadvancedweapons.alo	Groundbuildablesskirmish.xml Markers.xml Specialstructures.xml 
eb_officeracademy.alo	Groundbuildablesskirmish.xml Props_story.xml Specialstructures.xml 
rb_officeracademy.alo	Groundbuildablesskirmish.xml Specialstructures.xml 
eb_researchfacility.alo	Groundbuildablesskirmish.xml Specialstructures.xml 
rb_researchfacility.alo	Groundbuildablesskirmish.xml Multiplayer_structure_markers.xml Specialstructures.xml 
rb_comcenter.alo	Groundbuildablesskirmish.xml Hutt_faction_units.xml Multiplayer_structure_markers.xml Specialstructures.xml 
eb_commandcenter.alo	Groundbuildablesskirmish.xml Specialstructures.xml 
rb_commandcenter.alo	Groundbuildablesskirmish.xml Multiplayer_structure_markers.xml Specialstructures.xml 
w_pedistal.alo	Groundbuildablesskirmish.xml Markers.xml 
nb_cmc22mining_sml.alo	Groundbuildablesskirmish.xml Specialstructures.xml 
ub_barracks.alo	Groundbuildablesskirmish.xml Specialstructures_underworld.xml 
ub_palace.alo	Groundbuildablesskirmish.xml Specialstructures_underworld.xml 
ub_droidworks.alo	Groundbuildablesskirmish.xml Specialstructures_underworld.xml 
ub_heavyfactory.alo	Groundbuildablesskirmish.xml Specialstructures_underworld.xml 
w_buildbasefoc.alo	Groundbuildablesskirmish.xml 
w_huttpalace.alo	Groundbuildablesskirmish.xml Specialstructures.xml 
eb_magnepulsecannon.alo	Groundbuildablesskirmish.xml Specialstructures.xml 
eb_gravcontrolgen.alo	Groundbuildablesskirmish.xml Markers.xml Specialstructures.xml 
w_uplink_station.alo	Groundbuildablesskirmish.xml Groundstructures.xml 
nb_bunker.alo	Groundbuildablesskirmish.xml Specialstructures_underworld.xml 
eb_testbunker.alo	Groundbuildablesskirmish.xml Groundstructures.xml Specialstructures_underworld.xml 
rb_bunker.alo	Groundbuildablesskirmish.xml Specialstructures_underworld.xml 
ub_bunker.alo	Groundbuildablesskirmish.xml Specialstructures_underworld.xml 
nb_basepad_underworld.alo	Groundbuildablesunderworld.xml 
ub_turretmst50.alo	Groundbuildablesunderworld.xml Groundturrets.xml 
ub_turretptl05.alo	Groundbuildablesunderworld.xml Groundturrets.xml 
ev_at-at.alo	Groundcompaniesempire.xml Groundvehicles.xml Props_story.xml Uniqueunits.xml 
ev_at-st.alo	Groundcompaniesempire.xml Groundvehicles.xml Props_story.xml Units_land_underworld_scavengerdroids.xml 
rv_snowspeeder.alo	Groundcompaniesrebel.xml Groundvehicles.xml 
ri_plexsoldier.alo	Groundcompaniesrebel.xml Groundinfantry.xml 
ni_gmale_swamp_a.alo	Groundindigenous.xml Groundinfantry.xml 
ni_ewok.alo	Groundindigenous.xml 
ni_ewok_b.alo	Groundindigenous.xml Props_story.xml 
ni_ewok_c.alo	Groundindigenous.xml Props_story.xml 
ni_gmale_desert_a.alo	Groundindigenous.xml Props_story.xml 
ni_gmale_swamp_b.alo	Groundindigenous.xml 
ni_gmale_swamp_c.alo	Groundindigenous.xml 
ni_gmale_urban_b.alo	Groundindigenous.xml 
ni_gmale_urban_c.alo	Groundindigenous.xml 
ri_wookiee_unarmed.alo	Groundindigenous.xml 
ni_jawa.alo	Groundindigenous.xml Props_story.xml 
ni_sandpeople_b.alo	Groundindigenous.xml Props_story.xml 
ni_sandpeople_c.alo	Groundindigenous.xml 
ei_royalgaurd.alo	Groundindigenous.xml Groundinfantry.xml 
ni_hutt.alo	Groundindigenous.xml Hutt_faction_units.xml 
ni_nightsister_ranger.alo	Groundindigenous.xml Units_land_underworld_nightsister.xml 
ni_noghri.alo	Groundindigenous.xml Units_land_empire_noghri.xml 
ni_mustafarian.alo	Groundindigenous.xml 
ni_mandalorian.alo	Groundindigenous.xml 
wc_bantha.alo	Groundindigenous.xml Props_story.xml 
ai_wampa.alo	Groundindigenous.xml Props_story.xml 
ai_sarlacc.alo	Groundindigenous.xml Props_story.xml 
ai_rancor.alo	Groundindigenous.xml Props_story.xml Units_hero_underworld_silri.xml 
w_bird.alo	Groundindigenous.xml 
w_bird_medium.alo	Groundindigenous.xml 
w_bird_light.alo	Groundindigenous.xml Props_story.xml 
ai_sketto.alo	Groundindigenous.xml 
w_dustdevil.alo	Groundindigenous.xml 
w_bugs.alo	Groundindigenous.xml 
ai_womprat.alo	Groundindigenous.xml Props_story.xml 
ai_tauntaun.alo	Groundindigenous.xml Props_story.xml 
ai_shaaks.alo	Groundindigenous.xml Props_story.xml 
ai_groundbeetle.alo	Groundindigenous.xml Props_story.xml 
w_felucia_plant_01.alo	Groundindigenous.xml Props_felucia.xml Props_story.xml 
w_felucia_plant_purple.alo	Groundindigenous.xml 
w_felucia_plantbig_purple.alo	Groundindigenous.xml 
w_felucia_bulbplant.alo	Groundindigenous.xml 
ai_airwhale.alo	Groundindigenous.xml 
ai_dactillion.alo	Groundindigenous.xml 
ei_biker.alo	Groundinfantry.xml 
ei_trooper_snow.alo	Groundinfantry.xml 
ei_trooper_sand.alo	Groundinfantry.xml 
ri_plexs_snow.alo	Groundinfantry.xml 
ri_plexs_desert.alo	Groundinfantry.xml 
ri_infantry_snow.alo	Groundinfantry.xml 
ri_infantry_desert.alo	Groundinfantry.xml 
ri_pilot.alo	Groundinfantry.xml 
ri_infiltrator.alo	Groundinfantry.xml 
ni_piratesoldier.alo	Groundinfantry.xml 
ni_pirateplex.alo	Groundinfantry.xml 
w_disruptor_death.alo	Groundinfantry.xml 
w_infect.alo	Groundinfantry.xml 
nb_ewok_tree.alo	Groundstructures.xml 
w_urban_corbuild_a.alo	Groundstructures.xml Props_urban.xml 
nb_vch.alo	Groundstructures.xml Groundstructures_underworld.xml Props_volcanic.xml 
nb_dch.alo	Groundstructures.xml Props_desert.xml Props_story.xml 
nb_swamp_hut.alo	Groundstructures.xml 
nb_tch.alo	Groundstructures.xml 
nb_sch.alo	Groundstructures.xml Props_snow.xml 
nv_sand_crawler.alo	Groundstructures.xml 
nb_rancor_cave.alo	Groundstructures.xml Props_story.xml 
nb_vornskr_den.alo	Groundstructures.xml 
ai_wampacave.alo	Groundstructures.xml Props_story.xml 
nb_wookiee_tree.alo	Groundstructures.xml Props_forest.xml Props_story.xml 
nb_gunga_building.alo	Groundstructures.xml 
nb_sandpeople_tent.alo	Groundstructures.xml Props_story.xml 
nb_moncal_building.alo	Groundstructures.xml 
w_geonosis_tower01.alo	Groundstructures.xml 
nb_bothan_building.alo	Groundstructures.xml Props_story.xml 
nb_twilek_building.alo	Groundstructures.xml 
w_hutt_spawnbuilding.alo	Groundstructures.xml 
nb_sullest_cave.alo	Groundstructures.xml 
w_imperialpalace.alo	Groundstructures.xml 
nb_ich.alo	Groundstructures.xml 
nb_noghri_hut.alo	Groundstructures.xml 
nb_mustmushroom.alo	Groundstructures.xml 
nb_mandalorian_barracks.alo	Groundstructures.xml 
nb_nightsis_hut.alo	Groundstructures.xml 
eb_basewall-mid.alo	Groundstructures.xml Props_generic.xml Props_story.xml 
eb_basewall-crn.alo	Groundstructures.xml 
eb_basewall-inside-crn.alo	Groundstructures.xml 
nb_comm_jamm.alo	Groundstructures.xml 
eb_icc_landingpad.alo	Groundstructures.xml 
rb_basewall-mid.alo	Groundstructures.xml 
rb_basewall-corn.alo	Groundstructures.xml 
rb_basewall-inside-crn.alo	Groundstructures.xml 
rv_xwing_mission01.alo	Groundstructures.xml 
alttest.alo	Groundstructures.xml 
w_laser_invisible.alo	Groundstructures.xml Miscobjects.xml Projectiles.xml Upgradeobjects_underworld.xml 
ev_lambdashuttle.alo	Groundstructures.xml Transportunits.xml 
w_r2_terminal.alo	Groundstructures.xml 
w_uplink_station_abandon.alo	Groundstructures.xml 
eb_cin_basewall-mid_d.alo	Groundstructures.xml 
eb_cin_basewall-mid.alo	Groundstructures.xml Props_story.xml 
eb_checkpointstructure.alo	Groundstructures.xml 
nb_ysalamiri_tree.alo	Groundstructures_underworld.xml 
uv_mdu_sensor.alo	Groundturrets.xml 
uv_mdu_cage.alo	Groundturrets.xml 
uv_mdu_rocket.alo	Groundturrets.xml 
ev_mdu_fieldgen.alo	Groundturrets.xml 
ev_mdu_cgm.alo	Groundturrets.xml 
ev_mdu_sensornode.alo	Groundturrets.xml 
rv_mdu_shieldgen.alo	Groundturrets.xml 
rv_mdu_rflc.alo	Groundturrets.xml 
ev_at-aa.alo	Groundvehicles.xml Props_story.xml 
ev_spmat.alo	Groundvehicles.xml Props_story.xml 
p_smoke_small02.alo	Groundvehicles.xml Landbombingrununits.xml Particles.xml Units_land_empire_lancet.xml 
rv_mptl-2a.alo	Groundvehicles.xml 
rv_mptl-2aspotter.alo	Groundvehicles.xml 
rv_t2btank.alo	Groundvehicles.xml 
rv_t4btank.alo	Groundvehicles.xml 
ev_tiecrawler.alo	Groundvehicles.xml Props_story.xml 
ev_2mtank.alo	Groundvehicles.xml Props_story.xml 
nv_pskiff.alo	Groundvehicles.xml Hutt_faction_units.xml 
nv_pskiff_imperial.alo	Groundvehicles.xml 
nv_pskiff_rebel.alo	Groundvehicles.xml 
nv_pskiff_chew.alo	Groundvehicles.xml 
w_bespin_collector_droid.alo	Groundvehicles.xml 
ev_stardestroyer_hp00_l-f.alo	Hardpoints.xml Spaceprops.xml 
ev_stardestroyer_hp00_f-r.alo	Hardpoints.xml Spaceprops.xml 
ev_stardestroyer_hp00_b-l.alo	Hardpoints.xml Spaceprops.xml 
ev_stardestroyer_hp00_b-r.alo	Hardpoints.xml Spaceprops.xml 
ev_stardestroyer_hp00_m-l.alo	Hardpoints.xml 
ev_stardestroyer_hp00_m-r.alo	Hardpoints.xml 
ev_stardestroyer_hp00_e.alo	Hardpoints.xml 
rv_moncalcruiser_hp00_f-l.alo	Hardpoints.xml Spaceprops.xml 
rv_moncalcruiser_hp00_f-r.alo	Hardpoints.xml Spaceprops.xml 
rv_moncalcruiser_hp00_b-l.alo	Hardpoints.xml Spaceprops.xml 
rv_moncalcruiser_hp00_b-r.alo	Hardpoints.xml Spaceprops.xml 
rv_moncalcruiser_hp00_m-l.alo	Hardpoints.xml Spaceprops.xml 
rv_moncalcruiser_hp00_m-r.alo	Hardpoints.xml Spaceprops.xml 
rv_moncalcruiser_hp00_e.alo	Hardpoints.xml 
rv_corvette_leia_hp00_e.alo	Hardpoints.xml 
rv_nebulonb_hp00_f-l.alo	Hardpoints.xml Spaceprops.xml 
rv_nebulonb_hp00_f-r.alo	Hardpoints.xml Spaceprops.xml 
rv_nebulonb_hp00_b-l.alo	Hardpoints.xml Spaceprops.xml 
rv_nebulonb_hp00_b-r.alo	Hardpoints.xml Spaceprops.xml 
rv_nebulonb_hp00_e.alo	Hardpoints.xml 
ev_victorystardestroyer_hp00_c-f.alo	Hardpoints.xml Spaceprops.xml 
ev_victorystardestroyer_hp00_m-r.alo	Hardpoints.xml Spaceprops.xml 
ev_victorystardestroyer_hp00_m-l.alo	Hardpoints.xml Spaceprops.xml 
ev_victorystardestroyer_hp00_c-b.alo	Hardpoints.xml Spaceprops.xml 
ev_victorystardestroyer_hp00_e.alo	Hardpoints.xml 
ev_interdictor_hp00_f-l.alo	Hardpoints.xml Spaceprops.xml 
ev_interdictor_hp00_f-r.alo	Hardpoints.xml Spaceprops.xml 
ev_interdictor_hp00_b-l.alo	Hardpoints.xml Spaceprops.xml 
ev_interdictor_hp00_b-r.alo	Hardpoints.xml Spaceprops.xml 
ev_interdictor_hp00_c-m.alo	Hardpoints.xml 
ev_interdictor_hp00_c-b.alo	Hardpoints.xml 
ev_interdictor_hp00_e.alo	Hardpoints.xml 
rv_assaultfrigate_hp00_f-l.alo	Hardpoints.xml Spaceprops.xml 
rv_assaultfrigate_hp00_f-r.alo	Hardpoints.xml Spaceprops.xml 
rv_assaultfrigate_hp00_b-l.alo	Hardpoints.xml Spaceprops.xml 
rv_assaultfrigate_hp00_b-r.alo	Hardpoints.xml Spaceprops.xml 
rv_assaultfrigate_hp00_e.alo	Hardpoints.xml 
ev_acclamator_hp00_f-l.alo	Hardpoints.xml Props_generic.xml Spaceprops.xml 
ev_acclamator_hp00_f-r.alo	Hardpoints.xml Props_generic.xml Spaceprops.xml 
ev_acclamator_hp00_f-c.alo	Hardpoints.xml Props_generic.xml Spaceprops.xml 
ev_acclamator_hp00_b-l.alo	Hardpoints.xml Spaceprops.xml 
ev_acclamator_hp00_b-r.alo	Hardpoints.xml Props_generic.xml Spaceprops.xml 
ev_acclamator_hp00_b-c.alo	Hardpoints.xml 
ev_acclamator_hp00_e.alo	Hardpoints.xml 
rb_station_01_hp01_ccm.alo	Hardpoints.xml 
rb_station_01_hp01_lc.alo	Hardpoints.xml 
rb_station_01_hp01_tbl.alo	Hardpoints.xml Spaceprops.xml 
rb_station_01_hp01_shg.alo	Hardpoints.xml Props_generic.xml Spaceprops.xml 
rb_station_01_hp01_ca.alo	Hardpoints.xml Props_generic.xml Spaceprops.xml 
rb_station_02_hp02_lc.alo	Hardpoints.xml Spaceprops.xml 
rb_station_02_hp02_prt.alo	Hardpoints.xml 
rb_station_02_hp02_tbl.alo	Hardpoints.xml Spaceprops.xml 
rb_station_03_hp03_ccm.alo	Hardpoints.xml 
rb_station_03_hp03_ic.alo	Hardpoints.xml Spaceprops.xml 
rb_station_03_hp03_prt.alo	Hardpoints.xml Spaceprops.xml 
rb_station_04_hp04_ic.alo	Hardpoints.xml Props_generic.xml Spaceprops.xml 
rb_station_04_hp04_lc.alo	Hardpoints.xml Spaceprops.xml 
rb_station_04_hp04_tbl.alo	Hardpoints.xml Props_generic.xml Props_urban.xml Spaceprops.xml 
rb_station_04_hp04_shg.alo	Hardpoints.xml Spaceprops.xml 
rb_station_05_hp05_ccm.alo	Hardpoints.xml Spaceprops.xml 
rb_station_05_hp05_ic.alo	Hardpoints.xml Spaceprops.xml 
rb_station_05_hp05_prt.alo	Hardpoints.xml Props_generic.xml Spaceprops.xml 
rb_station_05_hp05_tbl.alo	Hardpoints.xml Spaceprops.xml 
rb_station_05_hp05_tbl2.alo	Hardpoints.xml Spaceprops.xml 
eb_station_01_hp01_cm.alo	Hardpoints.xml Spaceprops.xml 
eb_station_01_hp01_lc.alo	Hardpoints.xml Spaceprops.xml 
eb_station_01_hp01_tbl.alo	Hardpoints.xml Spaceprops.xml 
eb_station_01_hp01_shg.alo	Hardpoints.xml Spaceprops.xml 
eb_station_01_hp01_ca.alo	Hardpoints.xml Spaceprops.xml 
eb_station_02_hp02_lc.alo	Hardpoints.xml Spaceprops.xml 
eb_station_02_hp02_prt.alo	Hardpoints.xml Spaceprops.xml 
eb_station_02_hp02_tbl.alo	Hardpoints.xml Spaceprops.xml 
eb_station_03_hp03_cm.alo	Hardpoints.xml Spaceprops.xml 
eb_station_03_hp03_ic.alo	Hardpoints.xml Spaceprops.xml 
eb_station_03_hp03_prt.alo	Hardpoints.xml Spaceprops.xml 
eb_station_04_hp04_ic.alo	Hardpoints.xml Spaceprops.xml 
eb_station_04_hp04_lc.alo	Hardpoints.xml 
eb_station_04_hp04_tbl.alo	Hardpoints.xml Spaceprops.xml 
eb_station_05_hp05_cm.alo	Hardpoints.xml Spaceprops.xml 
eb_station_05_hp05_ic.alo	Hardpoints.xml Spaceprops.xml 
eb_station_05_hp05_prt.alo	Hardpoints.xml Spaceprops.xml 
eb_station_05_hp05_tbl.alo	Hardpoints.xml Spaceprops.xml 
rv_homeone_hp_shg.alo	Hardpoints.xml Spaceprops.xml 
rv_homeone_hp_tbl_bl.alo	Hardpoints.xml Spaceprops.xml 
rv_homeone_hp_tbl_br.alo	Hardpoints.xml Spaceprops.xml 
rv_homeone_hp_tbl_fl.alo	Hardpoints.xml Spaceprops.xml 
rv_homeone_hp_tbl_fr.alo	Hardpoints.xml Spaceprops.xml 
rv_homeone_hp_ic_bl.alo	Hardpoints.xml Spaceprops.xml 
rv_homeone_hp_ic_br.alo	Hardpoints.xml Spaceprops.xml 
rv_homeone_hp_ic_fl.alo	Hardpoints.xml Spaceprops.xml 
rv_homeone_hp_ic_fr.alo	Hardpoints.xml Spaceprops.xml 
nv_jedicruiser_hp_b-m.alo	Hardpoints.xml Props_generic.xml Spaceprops.xml 
nv_jedicruiser_hp_f-l.alo	Hardpoints.xml Props_generic.xml Spaceprops.xml 
nv_jedicruiser_hp_f-r.alo	Hardpoints.xml Props_generic.xml Spaceprops.xml 
nv_jedicruiser_hp_m-l.alo	Hardpoints.xml 
nv_jedicruiser_hp_m-r.alo	Hardpoints.xml 
nv_jedicruiser_hp_b-l.alo	Hardpoints.xml 
nv_jedicruiser_hp_b-r.alo	Hardpoints.xml 
nv_pirate_frigate_hp00_f.alo	Hardpoints.xml Spaceprops.xml 
nv_pirate_frigate_hp00_b-l.alo	Hardpoints.xml Spaceprops.xml 
nv_pirate_frigate_hp00_b-r.alo	Hardpoints.xml Spaceprops.xml 
nb_apbase_hp_ll1.alo	Hardpoints.xml Spaceprops.xml 
nb_apbase_hp_tl1.alo	Hardpoints.xml Spaceprops.xml 
nb_apbase_hp_tl2.alo	Hardpoints.xml Spaceprops.xml 
nb_apbase_hp_tl3.alo	Hardpoints.xml Spaceprops.xml 
nb_apbase_hp_tl4.alo	Hardpoints.xml Spaceprops.xml 
nb_apbase_hp_ht1.alo	Hardpoints.xml Spaceprops.xml 
nb_apbase_hp_ht2.alo	Hardpoints.xml Spaceprops.xml 
nb_apbase_hp_shg.alo	Hardpoints.xml Props_generic.xml Spaceprops.xml 
nb_apbase_hp_hb.alo	Hardpoints.xml Spaceprops.xml 
ev_executorstardestroyer_hp_l_trb00.alo	Hardpoints_underworld.xml Spaceprops_underworld.xml 
ev_executorstardestroyer_hp_l_trb01.alo	Hardpoints_underworld.xml Spaceprops_underworld.xml 
ev_executorstardestroyer_hp_l_trb02.alo	Hardpoints_underworld.xml Spaceprops_underworld.xml 
ev_executorstardestroyer_hp_l_trb03.alo	Hardpoints_underworld.xml Spaceprops_underworld.xml 
ev_executorstardestroyer_hp_l_trb04.alo	Hardpoints_underworld.xml 
ev_executorstardestroyer_hp_l_ion00.alo	Hardpoints_underworld.xml Spaceprops_underworld.xml 
ev_executorstardestroyer_hp_l_ion01.alo	Hardpoints_underworld.xml Spaceprops_underworld.xml 
ev_executorstardestroyer_hp_l_ion02.alo	Hardpoints_underworld.xml Spaceprops_underworld.xml 
ev_executorstardestroyer_hp_l_conm00.alo	Hardpoints_underworld.xml 
ev_executorstardestroyer_hp_l_conm01.alo	Hardpoints_underworld.xml 
ev_executorstardestroyer_hp_l_torp.alo	Hardpoints_underworld.xml 
ev_executorstardestroyer_hp_r_trb00.alo	Hardpoints_underworld.xml Spaceprops_underworld.xml 
ev_executorstardestroyer_hp_r_trb01.alo	Hardpoints_underworld.xml Spaceprops_underworld.xml 
ev_executorstardestroyer_hp_r_trb02.alo	Hardpoints_underworld.xml Spaceprops_underworld.xml 
ev_executorstardestroyer_hp_r_trb03.alo	Hardpoints_underworld.xml Spaceprops_underworld.xml 
ev_executorstardestroyer_hp_r_trb04.alo	Hardpoints_underworld.xml 
ev_executorstardestroyer_hp_r_ion00.alo	Hardpoints_underworld.xml Spaceprops_underworld.xml 
ev_executorstardestroyer_hp_r_ion01.alo	Hardpoints_underworld.xml Spaceprops_underworld.xml 
ev_executorstardestroyer_hp_r_ion02.alo	Hardpoints_underworld.xml Spaceprops_underworld.xml 
ev_executorstardestroyer_hp_r_conm00.alo	Hardpoints_underworld.xml 
ev_executorstardestroyer_hp_r_torp.alo	Hardpoints_underworld.xml 
ev_executorstardestroyer_hp_m_torp.alo	Hardpoints_underworld.xml 
ev_executorstardestroyer_hp_trac.alo	Hardpoints_underworld.xml 
ev_executorstardestroyer_hp_shld00.alo	Hardpoints_underworld.xml 
ev_executorstardestroyer_hp_shld01.alo	Hardpoints_underworld.xml 
ev_executorstardestroyer_hp_shld02.alo	Hardpoints_underworld.xml 
ev_executorstardestroyer_hp_e.alo	Hardpoints_underworld.xml 
ev_executorstardestroyer_hp_e2.alo	Hardpoints_underworld.xml 
uv_interceptoriv_hp00_f.alo	Hardpoints_underworld.xml Spaceprops_underworld.xml 
uv_interceptoriv_hp00_b-l.alo	Hardpoints_underworld.xml Spaceprops_underworld.xml 
uv_interceptoriv_hp00_b-r.alo	Hardpoints_underworld.xml Spaceprops_underworld.xml 
uv_kraytclassdestroyer_hp_ion_00.alo	Hardpoints_underworld.xml Spaceprops_underworld.xml 
uv_kraytclassdestroyer_hp_sw_00.alo	Hardpoints_underworld.xml Spaceprops_underworld.xml 
uv_kraytclassdestroyer_hp_lc_l_00.alo	Hardpoints_underworld.xml Spaceprops_underworld.xml 
uv_kraytclassdestroyer_hp_lc_l_00_tyber.alo	Hardpoints_underworld.xml Spaceprops_underworld.xml 
uv_kraytclassdestroyer_hp_lc_r_00.alo	Hardpoints_underworld.xml Spaceprops_underworld.xml 
uv_kraytclassdestroyer_hp_lc_r_00_tyber.alo	Hardpoints_underworld.xml Spaceprops_underworld.xml 
uv_kraytclassdestroyer_hp_shld_00.alo	Hardpoints_underworld.xml Spaceprops_underworld.xml 
uv_vengeance_hp_lft_mdc.alo	Hardpoints_underworld.xml Spaceprops_underworld.xml 
uv_vengeance_hp_rgt_mdc.alo	Hardpoints_underworld.xml Spaceprops_underworld.xml 
uv_vengeance_hp_lft_tb.alo	Hardpoints_underworld.xml Spaceprops_underworld.xml 
uv_kedalbebattleship_hp_tb_lft_00.alo	Hardpoints_underworld.xml Spaceprops_underworld.xml 
uv_kedalbebattleship_hp_tb_lft_01.alo	Hardpoints_underworld.xml Spaceprops_underworld.xml 
uv_kedalbebattleship_hp_tb_rgt_00.alo	Hardpoints_underworld.xml Spaceprops_underworld.xml 
uv_kedalbebattleship_hp_tb_rgt_01.alo	Hardpoints_underworld.xml Spaceprops_underworld.xml 
uv_kedalbebattleship_hp_ion_lft_00.alo	Hardpoints_underworld.xml Spaceprops_underworld.xml 
uv_kedalbebattleship_hp_ion_rgt_00.alo	Hardpoints_underworld.xml Spaceprops_underworld.xml 
uv_kedalbebattleship_hp_mdb_frnt_00.alo	Hardpoints_underworld.xml Spaceprops_underworld.xml 
uv_kedalbebattleship_hp_shl_00.alo	Hardpoints_underworld.xml Spaceprops_underworld.xml 
ev_archammer_hp_lc_l_00.alo	Hardpoints_underworld.xml Spaceprops_underworld.xml 
ev_archammer_hp_lc_r_00.alo	Hardpoints_underworld.xml Spaceprops_underworld.xml 
ub_01_station_hp01_com.alo	Hardpoints_underworld.xml Spaceprops_underworld.xml 
ub_01_station_hp01_shg.alo	Hardpoints_underworld.xml Spaceprops_underworld.xml 
ub_03_station_hp03_pt.alo	Hardpoints_underworld.xml Spaceprops_underworld.xml 
ub_03_station_hp03_gun.alo	Hardpoints_underworld.xml Spaceprops_underworld.xml 
ub_04_station_hp04_pc.alo	Hardpoints_underworld.xml Spaceprops_underworld.xml 
ub_05_station_hp05_ic.alo	Hardpoints_underworld.xml Spaceprops_underworld.xml 
ub_05_station_hp05_pt.alo	Hardpoints_underworld.xml Spaceprops_underworld.xml 
ub_05_station_hp05_tbl.alo	Hardpoints_underworld.xml Spaceprops_underworld.xml 
hp_leftshieldgen_00.alo	Hardpoints_underworld.xml Spaceprops_underworld.xml 
hp_rightshieldgen_00.alo	Hardpoints_underworld.xml Spaceprops_underworld.xml 
hp_turret_front_00.alo	Hardpoints_underworld.xml Spaceprops_underworld.xml 
hp_turret_back_00.alo	Hardpoints_underworld.xml Spaceprops_underworld.xml 
hp_turret_front_l_00.alo	Hardpoints_underworld.xml Spaceprops_underworld.xml 
hp_turret_front_r_00.alo	Hardpoints_underworld.xml Spaceprops_underworld.xml 
hp_turret_back_l_00.alo	Hardpoints_underworld.xml Spaceprops_underworld.xml 
hp_turret_back_r_00.alo	Hardpoints_underworld.xml Spaceprops_underworld.xml 
ub_palace_hp_gen.alo	Hardpoints_underworld.xml Spaceprops_underworld.xml 
ub_palace_hp_comm.alo	Hardpoints_underworld.xml Spaceprops_underworld.xml 
ev_stardestroyer_thrawn_hp00_l-f.alo	Hardpoints_underworld.xml Spaceprops_underworld.xml 
ev_stardestroyer_thrawn_hp00_f-r.alo	Hardpoints_underworld.xml Spaceprops_underworld.xml 
ev_stardestroyer_thrawn_hp00_b-l.alo	Hardpoints_underworld.xml Spaceprops_underworld.xml 
ev_stardestroyer_thrawn_hp00_b-r.alo	Hardpoints_underworld.xml Spaceprops_underworld.xml 
ev_stardestroyer_thrawn_hp00_m-l.alo	Hardpoints_underworld.xml 
ev_stardestroyer_thrawn_hp00_m-r.alo	Hardpoints_underworld.xml 
ev_stardestroyer_thrawn_hp00_m-c.alo	Hardpoints_underworld.xml Spaceprops_underworld.xml 
ev_stardestroyer_thrawn_hp00_e.alo	Hardpoints_underworld.xml 
rv_corvette.alo	Hutt_faction_units.xml Mov_cinematics.xml Spaceunitscorvettes.xml 
nv_ipv1.alo	Hutt_faction_units.xml Spaceunitscorvettes.xml Uniqueunits.xml 
rv_missile_ship.alo	Hutt_faction_units.xml Spaceunitscorvettes.xml 
nv_vwing.alo	Hutt_faction_units.xml Uniqueunits.xml 
nv_jedicruiser.alo	Hutt_faction_units.xml Props_generic.xml Uniqueunits.xml 
nb_apbase.alo	Hutt_faction_units.xml Starbases.xml 
i_pirate_station.alo	Hutt_faction_units.xml Starbases.xml 
ev_podwalker.alo	Hutt_faction_units.xml Uniqueunits.xml 
nv_swampspeeder_p.alo	Hutt_faction_units.xml Uniqueunits.xml 
w_huttpalace_variant.alo	Hutt_faction_units.xml 
ev_tiebomber.alo	Landbombingrununits.xml Props_story.xml Spaceunitsfighters.xml Squadrons.xml 
uv_skipray.alo	Landbombingrununits.xml Units_space_underworld_skipray.xml 
w_stars_greenscreen.alo	Landprimaryskydomes.xml Spaceprimaryskydomes.xml 
w_stars_blackscreen.alo	Landprimaryskydomes.xml Spaceprimaryskydomes.xml 
w_stars_purplescreen.alo	Landprimaryskydomes.xml Spaceprimaryskydomes.xml 
w_sky00.alo	Landprimaryskydomes.xml 
w_sky00_evening.alo	Landprimaryskydomes.xml 
w_sky_murk00.alo	Landprimaryskydomes.xml 
w_sky_murk00_huge.alo	Landprimaryskydomes.xml 
w_skysnow00.alo	Landprimaryskydomes.xml 
w_sky_desert00.alo	Landprimaryskydomes.xml 
w_skyclear00.alo	Landprimaryskydomes.xml 
w_sky_storm00.alo	Landprimaryskydomes.xml 
w_sky_desert00_evening.alo	Landprimaryskydomes.xml 
w_sky_nightclear00.alo	Landprimaryskydomes.xml 
w_sky_nightclear00_noflare.alo	Landprimaryskydomes.xml 
w_sky_thin_atmos00.alo	Landprimaryskydomes.xml 
w_sky_volcanic00.alo	Landprimaryskydomes.xml 
w_sky_smog00.alo	Landprimaryskydomes.xml Props_story.xml 
w_sky_bespin.alo	Landprimaryskydomes.xml Spacesecondaryskydomes.xml 
w_sky_interior.alo	Landprimaryskydomes.xml 
w_sky_interior2.alo	Landprimaryskydomes.xml 
w_sky_kamino.alo	Landprimaryskydomes.xml 
w_sky_utapau.alo	Landprimaryskydomes.xml 
w_skyorange_horizon_evening.alo	Landsecondaryskydomes.xml 
w_sky_urban_traffic00.alo	Landsecondaryskydomes.xml 
w_sky_rings00.alo	Landsecondaryskydomes.xml 
w_sky_rings01.alo	Landsecondaryskydomes.xml 
w_flag_marker_green.alo	Markers.xml 
w_flag_marker_blue.alo	Markers.xml 
nb_piratebase_01.alo	Markers.xml Specialstructures.xml 
nv_lrs.alo	Markers.xml Props_generic.xml Spacebuildablesskirmish.xml Specialstructures.xml 
rb_station_05.alo	Markers.xml Starbases.xml 
w_flag_marker_white.alo	Markers.xml Props_story.xml Scriptmarkers.xml 
w_flag_marker_yellow.alo	Markers.xml Scriptmarkers.xml 
w_flag_marker_red.alo	Markers.xml Miscobjects.xml 
w_planet_deathstar.alo	Markers.xml 
w_pedistal_faction.alo	Markers.xml 
w_pedistal_faction_1.alo	Markers.xml 
w_pedistal_faction_2.alo	Markers.xml 
w_pedistal_faction_3.alo	Markers.xml 
w_pedistal_faction_4.alo	Markers.xml 
w_pedistal_faction_5.alo	Markers.xml 
w_pedistal_faction_10.alo	Markers.xml 
w_pedistal_rebel.alo	Markers.xml Multiplayer_structure_markers.xml 
w_pedistal_imperial.alo	Markers.xml Props_story.xml 
w_pedistal_underworld.alo	Markers.xml 
w_flag_marker_purple.alo	Markers.xml Scriptmarkers.xml 
ui_saboteur.alo	Minor_heroes_expansion.xml 
w_smallbomb.alo	Miscobjects.xml Projectiles.xml Props_story.xml 
w_pick_up_coins.alo	Miscobjects.xml Particles.xml 
i_multiplayer_beacon.alo	Miscobjects.xml 
p_contamination_cloud.alo	Miscobjects.xml 
w_landmine.alo	Miscobjects.xml Projectiles.xml 
mdp_00.alo	Mobile_defense_units.xml 
uv_mdu.alo	Mobile_defense_units.xml 
ev_mdu.alo	Mobile_defense_units.xml 
rv_mdu.alo	Mobile_defense_units.xml 
w_prop_deadbothan.alo	Mov_cinematics.xml 
mov_empire_intro_shuttle.alo	Mov_cinematics.xml 
mov_rebel_intro.alo	Mov_cinematics.xml Spaceprops.xml 
mov_ei_fieldcommander.alo	Mov_cinematics.xml 
mov_em6_prison_wookies.alo	Mov_cinematics.xml 
ri_wookiee_captured.alo	Mov_cinematics.xml 
ev_tieadvanced.alo	Mov_cinematics.xml Uniqueunits.xml 
ev_tartancruiser.alo	Mov_cinematics.xml Spaceunitscorvettes.xml 
mov_mothma.alo	Mov_cinematics.xml 
ri_r2d3.alo	Mov_cinematics.xml 
rv_mfalcon.alo	Mov_cinematics.xml Uniqueunits.xml 
rb_station_01.alo	Multiplayer_structure_markers.xml Starbases.xml 
eb_station_01.alo	Multiplayer_structure_markers.xml Starbases.xml 
ei_bobafett.alo	Namedherounits.xml 
ei_palpatine.alo	Namedherounits.xml 
ri_hansolo.alo	Namedherounits.xml 
ri_chewbacca.alo	Namedherounits.xml 
ei_marajade.alo	Namedherounits.xml 
ri_obiwan.alo	Namedherounits.xml 
ri_kylekatarn.alo	Namedherounits.xml 
ri_r2.alo	Namedherounits.xml 
ri_c3po.alo	Namedherounits.xml 
p_mouse_click.alo	Particles.xml 
p_mouse_double_click.alo	Particles.xml 
p_mouse_click_attack.alo	Particles.xml 
p_mouse_guard.alo	Particles.xml 
p_shield_penetration_generic.alo	Particles.xml 
p_dirt_emitter_test1.alo	Particles.xml 
test_rain.alo	Particles.xml 
p_lava_bubbles.alo	Particles.xml 
p_hover_generic.alo	Particles.xml 
p_steam_small01.alo	Particles.xml 
p_explosion_small00.alo	Particles.xml 
p_explosion_empire_small00.alo	Particles.xml 
p_explosion_med00.alo	Particles.xml 
p_explosion_empire_med00.alo	Particles.xml 
p_explosion_big00.alo	Particles.xml 
p_explosion_empire_big00.alo	Particles.xml 
p_explosion_huge00.alo	Particles.xml 
p_explosion_friggin_huge00.alo	Particles.xml 
p_explosion_empire_friggin_huge00.alo	Particles.xml 
p_explosion_empire_huge00.alo	Particles.xml 
p_explosion_empire_huge00_no_debris.alo	Particles.xml 
p_explosion_small01.alo	Particles.xml 
p_explosion_missile_ground01.alo	Particles.xml 
p_explosion_thermal_empire.alo	Particles.xml 
p_explosion_thermal_underworld.alo	Particles.xml 
p_explosion_thermal_rebel.alo	Particles.xml 
p_seismic_explosion00.alo	Particles.xml 
p_explosion_med01.alo	Particles.xml 
p_explosion_big01.alo	Particles.xml 
p_sab_bomb.alo	Particles.xml 
p_ewok_suicide.alo	Particles.xml 
p_explosion_atat01.alo	Particles.xml 
p_explosion_huge01.alo	Particles.xml 
p_damage_small00.alo	Particles.xml 
p_damage_med00.alo	Particles.xml 
p_damage_big00.alo	Particles.xml 
p_spmat_splash.alo	Particles.xml 
p_self_destruct_effect.alo	Particles.xml 
p_weaken_enemy_detonation_effect.alo	Particles.xml 
p_explosion_tiny00_dud.alo	Particles.xml 
p_explosion_med00_dud.alo	Particles.xml 
p_desert_ground_puff.alo	Particles.xml 
p_shield_blast_small00.alo	Particles.xml 
p_shield_blast_med00.alo	Particles.xml 
p_shield_blast_large00.alo	Particles.xml 
p_shield_large01.alo	Particles.xml 
p_explosion_empire_med00_no_debris.alo	Particles.xml 
p_ataa_footpuff_default.alo	Particles.xml 
p_atat_footpuff_dirt.alo	Particles.xml 
p_splash_wake.alo	Particles.xml 
p_atat_footpuff_grass.alo	Particles.xml 
p_atat_footpuff_snow.alo	Particles.xml 
p_explosion_thermal_small00.alo	Particles.xml 
p_explosion_flak01.alo	Particles.xml 
p_rain_splash.alo	Particles.xml 
p_splash_bullet.alo	Particles.xml 
p_splash_wake_continuous.alo	Particles.xml 
p_splash_wake_lava.alo	Particles.xml 
p_ice_ground_puff.alo	Particles.xml 
p_landing_dust_temperate.alo	Particles.xml 
p_landing_dust_snow.alo	Particles.xml 
p_landing_dust_desert.alo	Particles.xml 
p_landing_dust_forest.alo	Particles.xml 
p_landing_dust_swamp.alo	Particles.xml 
p_landing_dust_volcanic.alo	Particles.xml 
p_landing_dust_urban.alo	Particles.xml 
p_magnespulse_buildup.alo	Particles.xml 
p_magna_explosion.alo	Particles.xml 
p_magnepulse_damage00.alo	Particles.xml 
p_heal00.alo	Particles.xml 
p_force_distract.alo	Particles.xml 
p_stun_fx.alo	Particles.xml 
p_corrupt_fx.alo	Particles.xml 
p_tani_stun.alo	Particles.xml 
p_instant_heal.alo	Particles.xml 
p_force_push.alo	Particles.xml 
p_force_whirlwind.alo	Particles.xml 
p_force_convert.alo	Particles.xml 
p_lure_object_particle_effect.alo	Particles.xml 
p_canderous_lure.alo	Particles.xml 
p_at-at_powerup.alo	Particles.xml 
p_piet_powerup.alo	Particles.xml 
p_replenish_wingmen_particle_effect.alo	Particles.xml 
p_weaken_enemy_particle_effect.alo	Particles.xml 
p_telekenesis_attack.alo	Particles.xml 
p_home_one_target.alo	Particles.xml 
p_stealing.alo	Particles.xml 
p_smoke_small01.alo	Particles.xml 
p_smoke_small00.alo	Particles.xml 
p_smoke_med01.alo	Particles.xml 
p_smoke_med00.alo	Particles.xml 
p_smoke_big01.alo	Particles.xml 
p_smoke_big00.alo	Particles.xml 
p_shield_small01.alo	Particles.xml 
p_shield_med01.alo	Particles.xml 
p_bothan_stun_explosion.alo	Particles.xml 
p_dazed.alo	Particles.xml 
p_invulnerable00.alo	Particles.xml 
p_planet_explode_300.alo	Particles.xml 
p_fire_small00.alo	Particles.xml 
p_fire_med00.alo	Particles.xml 
p_fire_big00.alo	Particles.xml 
p_fire_huge00.alo	Particles.xml 
p_fire_empire_small00.alo	Particles.xml 
p_fire_empire_med00.alo	Particles.xml 
p_fire_empire_big00.alo	Particles.xml 
p_fire_empire_huge00.alo	Particles.xml 
p_girder_dust_med00.alo	Particles.xml 
p_antilles_rescue.alo	Particles.xml 
p_fire_med01.alo	Particles.xml 
p_planet_corrupt.alo	Particles.xml 
p_planet_corrupt_large.alo	Particles.xml 
p_planet_corrupt2.alo	Particles.xml 
p_greenglow.alo	Particles.xml Projectiles.xml 
p_blueglow.alo	Particles.xml 
p_e_orbital_blast.alo	Particles.xml 
p_r_orbital_blast.alo	Particles.xml 
p_kraytdestoyer_detonate.alo	Particles.xml 
p_detonate_friggin_huge00_backup3_special.alo	Particles.xml 
p_orbital_impact_emit4.alo	Particles.xml 
p_orbital_impact_ionburst.alo	Particles.xml 
--p_orbital_impact_ion.alo	Particles.xml 
p_force_confuse.alo	Particles.xml 
w_bribery_credit.alo	Particles.xml 
p_corrupt_bribery.alo	Particles.xml 
p_buildup.alo	Particles.xml 
p_pulse_self_destruct_effect.alo	Particles.xml 
p_heat_pulsetank.alo	Particles.xml 
p_urai_poison.alo	Particles.xml 
p_leech_shield.alo	Particles.xml 
p_garg_flare.alo	Particles.xml 
p_rancor_summon.alo	Particles.xml 
p_corrupt_ship.alo	Particles.xml 
p_mind_trick.alo	Particles.xml 
p_corrupt_system.alo	Particles.xml 
p_carbonite_explosion.alo	Particles.xml 
p_sensorjammer.alo	Particles.xml 
p_tybergun.alo	Particles.xml 
p_plasma_burn.alo	Particles.xml 
p_nullified_force.alo	Particles.xml 
p_repulsor_snare.alo	Particles.xml 
p_explosion_galactic_underworld.alo	Particles.xml 
w_galaxy00.alo	Planets.xml 
w_planet_temperate01.alo	Planets.xml 
w_planet_asteroids.alo	Planets.xml 
w_planet_volcanic01.alo	Planets.xml 
w_planet_ice01.alo	Planets.xml 
w_planet_swamp01.alo	Planets.xml 
w_planet_gas01.alo	Planets.xml 
w_planet_ocean01.alo	Planets.xml 
w_planet_bonadan_low.alo	Planets.xml 
w_planet_urban01.alo	Planets.xml 
w_planet_forest01.alo	Planets.xml 
w_planet_dagobah_low.alo	Planets.xml 
w_planet_dantooine01.alo	Planets.xml 
w_planet_endor_low.alo	Planets.xml 
w_planet_eriadu_low.alo	Planets.xml 
w_planet_geonosis_low.alo	Planets.xml 
w_planet_desert01.alo	Planets.xml 
w_planet_hoth_low.alo	Planets.xml 
w_planet_kamino_low.alo	Planets.xml 
w_planet_kessel_low.alo	Planets.xml 
w_planet_korriban01.alo	Planets.xml 
w_planet_kuat_low.alo	Planets.xml 
w_planet_moncalamari01.alo	Planets.xml 
w_planet_alderaan_low.alo	Planets.xml 
w_planet_naboo_low.alo	Planets.xml 
w_planet_nalhutta01.alo	Planets.xml 
w_planet_ryloth_low.alo	Planets.xml 
w_planet_taris01.alo	Planets.xml 
w_planet_tatooine_low.alo	Planets.xml 
w_black_hole_small.alo	Planets.xml 
w_planet_thyferra01.alo	Planets.xml 
w_planet_utapau_low.alo	Planets.xml 
w_planet_wayland_low.alo	Planets.xml 
w_planet_yaviniv_low.alo	Planets.xml 
w_laser_small.alo	Projectiles.xml 
w_laser_smallg.alo	Projectiles.xml 
w_laser_medium.alo	Projectiles.xml 
p_lucky.alo	Projectiles.xml 
pion_ioncannonshot.alo	Projectiles.xml 
w_laser_mediumg.alo	Projectiles.xml 
w_laser_large.alo	Projectiles.xml 
w_laser_largeg.alo	Projectiles.xml 
w_concussion_missile.alo	Projectiles.xml Props_generic.xml 
ri_saber_spin.alo	Projectiles.xml Props_story.xml 
w_ewok_rock.alo	Projectiles.xml 
w_gungan_projectile.alo	Projectiles.xml 
w_flack_pod.alo	Projectiles.xml 
w_proton_projectile.alo	Projectiles.xml 
p_spmat_shot.alo	Projectiles.xml 
p_hyper_gun_slug.alo	Projectiles.xml 
p_ion_cannon00.alo	Projectiles.xml 
p_turbolaser_burst_med00_green.alo	Projectiles.xml 
p_turbolaser_burst_med00.alo	Projectiles.xml 
p_magnepulse_shot.alo	Projectiles.xml 
w_thermal_detonator.alo	Projectiles.xml 
w_thermal_detonator_empire.alo	Projectiles.xml 
w_thermal_detonator_underworld.alo	Projectiles.xml 
w_thermal_detonator_rebel.alo	Projectiles.xml 
p_seismic_bomb00.alo	Projectiles.xml 
p_disruptor_projectile.alo	Projectiles.xml 
p_kraytdestoyer_presuperblast.alo	Projectiles.xml 
p_kraytdestoyer_superblast.alo	Projectiles.xml 
p_kraytdestroyer_superblast_special.alo	Projectiles.xml 
p_blueglow2.alo	Projectiles.xml 
p_proton_vengance_small.alo	Projectiles.xml 
p_proton_vengance.alo	Projectiles.xml 
p_mz8shot.alo	Projectiles.xml 
p_urai_poison_projectile.alo	Projectiles.xml 
w_grenade.alo	Projectiles.xml 
w_carbonite_missile.alo	Projectiles.xml 
p_ui_spacestation.alo	Projectiles.xml 
w_rockclstr02.alo	Props_desert.xml 
w_rockclstr03.alo	Props_desert.xml 
w_rockslide00.alo	Props_desert.xml 
w_prop_moistcollect.alo	Props_desert.xml Props_urban.xml 
w_bush_tat00.alo	Props_desert.xml Props_felucia.xml 
w_bush_tat01.alo	Props_desert.xml Props_felucia.xml 
w_bush_tat02.alo	Props_desert.xml Props_felucia.xml 
w_leafbush00.alo	Props_desert.xml Props_felucia.xml Props_forest.xml 
w_tree_tat00.alo	Props_desert.xml Props_felucia.xml 
w_tree_tat00_cluster.alo	Props_desert.xml Props_felucia.xml 
w_tree_alien_02_cluster.alo	Props_desert.xml 
w_tree_alien_ns02_cluster.alo	Props_desert.xml Props_felucia.xml 
w_tree_alien_02_hi.alo	Props_desert.xml Props_felucia.xml 
w_tat_rockform00.alo	Props_desert.xml Props_felucia.xml 
w_tat_rockform01.alo	Props_desert.xml Props_felucia.xml 
w_tat_rockform02.alo	Props_desert.xml 
w_geonosis_rockform00.alo	Props_desert.xml 
w_geo_rockform01.alo	Props_desert.xml 
w_sandstorm00.alo	Props_desert.xml 
w_kraytdragonskull.alo	Props_desert.xml Props_story.xml 
w_kraytdragonribs.alo	Props_desert.xml Props_story.xml 
w_kraytdragontail.alo	Props_desert.xml Props_story.xml 
nb_dch_b.alo	Props_desert.xml Props_story.xml 
nb_dch_c.alo	Props_desert.xml Props_story.xml 
w_tree_seluca.alo	Props_desert.xml 
w_treepalm_ns_cluster.alo	Props_desert.xml Props_temperate.xml 
w_asteroid03.alo	Props_desert.xml Spaceprops.xml Specialstructures.xml 
w_asteroid01.alo	Props_desert.xml Spaceprops.xml Specialstructures.xml 
w_asteroid00.alo	Props_desert.xml Spaceprops.xml Specialstructures.xml 
w_asteroid02.alo	Props_desert.xml Spaceprops.xml Specialstructures.xml 
w_seluca_rock.alo	Props_desert.xml 
w_utapau_hole.alo	Props_desert.xml 
w_lightbeams.alo	Props_felucia.xml Props_swamp.xml 
w_felucia_rock_arch00.alo	Props_felucia.xml Props_temperate.xml 
w_kessel_rockform.alo	Props_felucia.xml 
w_volcano_rock00.alo	Props_felucia.xml Props_volcanic.xml 
w_volcano_rock01.alo	Props_felucia.xml Props_volcanic.xml 
w_fern03.alo	Props_felucia.xml Props_swamp.xml 
w_fern02.alo	Props_felucia.xml Props_swamp.xml 
w_fern00.alo	Props_felucia.xml Props_forest.xml 
w_fern01.alo	Props_felucia.xml Props_forest.xml 
w_bush_temp00.alo	Props_felucia.xml Props_temperate.xml 
w_bush_temp02.alo	Props_felucia.xml Props_temperate.xml 
w_grndcvr_e.alo	Props_felucia.xml Props_forest.xml 
w_grndcvr_f.alo	Props_felucia.xml Props_forest.xml 
w_grndcvr_g.alo	Props_felucia.xml Props_forest.xml 
w_grndcvr_h.alo	Props_felucia.xml Props_forest.xml 
w_grndcvr_i.alo	Props_felucia.xml Props_forest.xml 
w_temp_cattail.alo	Props_felucia.xml Props_temperate.xml 
w_grndcvr_a.alo	Props_felucia.xml Props_temperate.xml 
w_grndcvr_felucia_tall.alo	Props_felucia.xml 
w_swampgrass00.alo	Props_felucia.xml Props_swamp.xml 
w_tree_alien_00_hi.alo	Props_felucia.xml Props_temperate.xml 
w_tree_alien_ns_cluster.alo	Props_felucia.xml Props_temperate.xml 
w_endrrockclstr00.alo	Props_felucia.xml Props_forest.xml 
w_endrrockclstr01.alo	Props_felucia.xml Props_forest.xml 
w_endrrockclstr02.alo	Props_felucia.xml Props_forest.xml 
w_endrrockclstr03.alo	Props_felucia.xml Props_forest.xml 
w_lavarockclstr00.alo	Props_felucia.xml Props_volcanic.xml 
w_lavarockclstr01.alo	Props_felucia.xml Props_volcanic.xml 
w_lavarockclstr02.alo	Props_felucia.xml Props_volcanic.xml 
w_lavarockclstr03.alo	Props_felucia.xml Props_volcanic.xml 
w_ruins00.alo	Props_felucia.xml Props_temperate.xml 
w_ruins01.alo	Props_felucia.xml Props_temperate.xml 
w_ruins02.alo	Props_felucia.xml Props_temperate.xml 
w_ruins03.alo	Props_felucia.xml Props_temperate.xml 
w_felucia_plant_03.alo	Props_felucia.xml 
w_felucia_plant_02.alo	Props_felucia.xml 
w_felucia_plant_04.alo	Props_felucia.xml 
w_felucia_plant_05.alo	Props_felucia.xml 
w_felucia_plant_06.alo	Props_felucia.xml Props_story.xml 
w_felucia_plant_00_short.alo	Props_felucia.xml 
w_felucia_plant_00_medium.alo	Props_felucia.xml 
w_felucia_plant_00_tall.alo	Props_felucia.xml Props_story.xml 
w_endrrckslide00.alo	Props_forest.xml 
w_treepine_stmp00.alo	Props_forest.xml 
w_treeredwood_stmp00.alo	Props_forest.xml 
w_tree_ever_00_hi.alo	Props_forest.xml 
w_tree_ever_ns_cluster.alo	Props_forest.xml 
w_tree_ever_ns2_cluster.alo	Props_forest.xml 
w_tree_ever_canopy_a.alo	Props_forest.xml 
w_tree_ever_canopy_b.alo	Props_forest.xml 
w_tree_ever_00_cluster.alo	Props_forest.xml 
nb_wookiee_tree_plain.alo	Props_forest.xml 
w_tree_ever_01_hi.alo	Props_forest.xml 
w_tree_ever_01_cluster.alo	Props_forest.xml 
w_treepine01.alo	Props_forest.xml 
w_tree_dec_01_hi.alo	Props_forest.xml Props_temperate.xml 
w_allshaders.alo	Props_generic.xml 
w_allshaders_notext.alo	Props_generic.xml 
w_prop_elecbox.alo	Props_generic.xml Props_urban.xml 
w_prop_concretepad.alo	Props_generic.xml 
w_prop_generator.alo	Props_generic.xml Props_urban.xml 
w_prop_pwrbox.alo	Props_generic.xml Props_story.xml Props_urban.xml 
rv_snowspeeder_dmg.alo	Props_generic.xml 
w_lava_heat_particle1.alo	Props_generic.xml Props_volcanic.xml 
w_crates01.alo	Props_generic.xml 
w_crates02.alo	Props_generic.xml 
w_crates03.alo	Props_generic.xml 
w_crates04.alo	Props_generic.xml 
w_crates05.alo	Props_generic.xml 
w_crates06.alo	Props_generic.xml 
w_crates07.alo	Props_generic.xml 
w_crates08.alo	Props_generic.xml Props_story.xml 
w_crates09.alo	Props_generic.xml 
w_crates10.alo	Props_generic.xml 
w_crates11.alo	Props_generic.xml Props_story.xml 
w_crates12.alo	Props_generic.xml 
w_crates13.alo	Props_generic.xml 
w_crates14.alo	Props_generic.xml 
w_crates15.alo	Props_generic.xml 
w_crates16.alo	Props_generic.xml 
w_crates17.alo	Props_generic.xml 
w_crates18.alo	Props_generic.xml 
w_crates19.alo	Props_generic.xml 
w_crates20.alo	Props_generic.xml 
w_crates21.alo	Props_generic.xml 
w_crates22.alo	Props_generic.xml 
w_crates23.alo	Props_generic.xml 
w_crates24.alo	Props_generic.xml 
w_crates25.alo	Props_generic.xml 
w_crates26.alo	Props_generic.xml 
w_crates27.alo	Props_generic.xml 
w_crates28.alo	Props_generic.xml 
w_crates29.alo	Props_generic.xml 
w_gunganhead.alo	Props_generic.xml Props_story.xml 
w_fuel_pipe00.alo	Props_generic.xml 
w_fuel_pipe01.alo	Props_generic.xml 
w_fuel_pipe02.alo	Props_generic.xml 
w_droid_steam.alo	Props_generic.xml 
w_fuel_cell_1.alo	Props_generic.xml 
w_fuel_cell_2.alo	Props_generic.xml 
w_fuel_cell_3.alo	Props_generic.xml 
w_massassi_temple.alo	Props_generic.xml 
w_observation_tower.alo	Props_generic.xml Props_story.xml 
i_facing_arrow.alo	Props_generic.xml Spaceprops.xml 
ev_crashed_tyderium.alo	Props_generic.xml 
w_fish.alo	Props_generic.xml 
w_goodground_bags.alo	Props_generic.xml 
nv_sandspeeder.alo	Props_generic.xml 
nb_cage.alo	Props_generic.xml Props_story.xml 
ev_acclamator.alo	Props_generic.xml Spaceunitsfrigates.xml 
ev_acclamator_wreck_a01.alo	Props_generic.xml 
ev_acclamator_wreck_a.alo	Props_generic.xml 
uv_kraytclassdestroyer_cine.alo	Props_generic.xml 
uv_interceptoriv_cine.alo	Props_generic.xml 
w_planet_endor_high.alo	Props_generic.xml Spaceprops.xml 
w_planet_kessel_cine.alo	Props_generic.xml 
w_kessel_ships.alo	Props_generic.xml 
w_stars_cine_noflare.alo	Props_generic.xml 
w_space_girder00.alo	Props_generic.xml Spaceprops.xml 
w_generic_generator.alo	Props_generic.xml 
w_explosive_crate.alo	Props_generic.xml 
test_wall.alo	Props_generic.xml 
w_alphagirder.alo	Props_generic.xml 
w_sithartifact_pedestal.alo	Props_generic.xml Props_story.xml 
w_orbital_nightcloak.alo	Props_generic.xml 
w_rockclstr.alo	Props_snow.xml 
w_rockclstr00.alo	Props_snow.xml 
w_rockclstr01.alo	Props_snow.xml 
w_crystals_illum.alo	Props_snow.xml 
w_icerckslide00.alo	Props_snow.xml 
w_tree_ever_snow01_hi.alo	Props_snow.xml 
w_tree_ever_snow01_cluster.alo	Props_snow.xml 
w_tree_ever_snowns01_cluster.alo	Props_snow.xml 
w_tree_ever_snowns02_cluster.alo	Props_snow.xml 
w_tree_ever_snow02_hi.alo	Props_snow.xml 
w_tree_ever_snow02_cluster.alo	Props_snow.xml 
w_icemntrnge00.alo	Props_snow.xml 
w_icemntrnge01.alo	Props_snow.xml Props_story.xml 
w_hothdoors.alo	Props_snow.xml 
w_hothdoorsgreg.alo	Props_snow.xml 
w_snowwind.alo	Props_snow.xml 
ev_tiefighter.alo	Props_story.xml Spaceunitsfighters.xml Squadrons.xml 
w_star_destroyer_construction.alo	Props_story.xml Spaceprops.xml 
w_star_destroyer_construction_d.alo	Props_story.xml 
ev_lambdashuttle_space.alo	Props_story.xml Transportunits.xml 
eb_construction_pod.alo	Props_story.xml Spaceprops.xml 
w_orbital_resource_container.alo	Props_story.xml 
w_orbital_resource_container_small.alo	Props_story.xml 
eb_dock00.alo	Props_story.xml Spaceprops.xml 
eb_dock_break.alo	Props_story.xml 
w_at-at_construction.alo	Props_story.xml 
w_spice_crate.alo	Props_story.xml 
ui_tyber_in_jail.alo	Props_story.xml 
ni_gmale_urbanprison_a.alo	Props_story.xml 
ni_gmale_urbanprison_b.alo	Props_story.xml 
ni_gmale_urbanprison_c.alo	Props_story.xml 
ni_gmale_urbanprison_d.alo	Props_story.xml 
ni_gmale_urbanprison_e.alo	Props_story.xml 
ni_piratesoldierprison.alo	Props_story.xml 
rv_mfalcon_land.alo	Props_story.xml Uniqueunits.xml 
nv_lds.alo	Props_story.xml Spacebuildablesskirmish.xml Specialstructures.xml 
eb_cin_basewall-thresh.alo	Props_story.xml 
w_prison_terminal.alo	Props_story.xml 
ev_at-barge.alo	Props_story.xml Transportunits.xml 
w_planet_deathstar02_ii.alo	Props_story.xml Spaceunitssupers.xml 
w_urbanblock_a.alo	Props_story.xml Props_urban.xml 
w_planet_moon_high.alo	Props_story.xml Spaceprops.xml 
w_planet_desert-urban_high.alo	Props_story.xml Spaceprops.xml 
w_planet_swamp00.alo	Props_story.xml Spaceprops.xml 
rv_z-95.alo	Props_story.xml Spaceunitsfighters.xml 
w_tree_gnarl_00_hi.alo	Props_story.xml Props_swamp.xml 
ai_dianoga.alo	Props_story.xml Props_swamp.xml 
w_tree_dec_canopy_a.alo	Props_story.xml Props_temperate.xml 
w_tempmntrnge00.alo	Props_story.xml Props_temperate.xml 
w_theedbuild_b.alo	Props_story.xml Props_temperate.xml 
w_theedbuild_c.alo	Props_story.xml Props_temperate.xml 
w_sithtomb.alo	Props_story.xml Props_temperate.xml 
w_sithstatue.alo	Props_story.xml Props_temperate.xml 
w_black_box.alo	Props_story.xml 
w_theedwall_a.alo	Props_story.xml Props_temperate.xml 
w_theedwall_b.alo	Props_story.xml Props_temperate.xml 
w_theedwall_c.alo	Props_story.xml Props_temperate.xml 
w_urbancorner_a.alo	Props_story.xml Props_urban.xml 
w_prop_darktrooper_one.alo	Props_story.xml 
w_prop_darktrooper_two.alo	Props_story.xml 
w_prop_darktroop_three.alo	Props_story.xml 
w_bountyhunter.alo	Props_story.xml 
w_alarm_light.alo	Props_story.xml 
ni_darksideadepts.alo	Props_story.xml 
w_prison_bars.alo	Props_story.xml 
eb_governorsquarters.alo	Props_story.xml 
eb_guardtower.alo	Props_story.xml 
w_dathbridge.alo	Props_story.xml 
w_cloud_car.alo	Props_story.xml 
w_bespin_refinery.alo	Props_story.xml 
w_prop_deadmen_a.alo	Props_story.xml 
w_prop_deadat-st_a.alo	Props_story.xml 
w_prop_deadat-st_b.alo	Props_story.xml 
w_droidconvey_a.alo	Props_story.xml 
w_propdeadst.alo	Props_story.xml 
ni_twilek_f_nogun.alo	Props_story.xml 
ni_gmale_urban_c_nogun.alo	Props_story.xml 
ni_moncalciv_nogun.alo	Props_story.xml 
ni_sullustan_nogun.alo	Props_story.xml 
ev_executorstardestroyer.alo	Props_story.xml Units_space_empire_executor.xml 
eb_station_05.alo	Props_story.xml Starbases.xml 
i_eb_station_level5.alo	Props_story.xml Starbases.xml 
uv_rz-52boardingship.alo	Props_story.xml Underworld_transportunits.xml Units_hero_underworld_tyber_zann.xml 
w_jail_bed.alo	Props_story.xml 
w_jail_bed_tyber.alo	Props_story.xml 
w_urai_hologram.alo	Props_story.xml 
w_jaba.alo	Props_story.xml 
w_mousedroid_solo.alo	Props_story.xml 
w_sithartifact.alo	Props_story.xml 
w_shaakskull.alo	Props_story.xml 
w_urbanhalfwall_side.alo	Props_story.xml Props_urban.xml 
w_swampgasemit.alo	Props_swamp.xml 
w_bush_swmp00.alo	Props_swamp.xml 
w_swampvine00.alo	Props_swamp.xml 
w_swampvine01.alo	Props_swamp.xml 
w_tree_swmp_00_hi.alo	Props_swamp.xml 
w_tree_swmp_00_cluster.alo	Props_swamp.xml 
w_tree_swmp_ns_cluster.alo	Props_swamp.xml 
w_tree_bamboo_00_hi.alo	Props_swamp.xml 
w_tree_bamboo_00_cluster.alo	Props_swamp.xml 
w_tree_bamboo_ns_cluster.alo	Props_swamp.xml 
w_treeswampcard00.alo	Props_swamp.xml 
w_temprockclstr00.alo	Props_temperate.xml 
w_temprockclstr01.alo	Props_temperate.xml 
w_temprockclstr02.alo	Props_temperate.xml 
w_temprockclstr03.alo	Props_temperate.xml 
w_swampgrass01.alo	Props_temperate.xml 
w_bush_cypress.alo	Props_temperate.xml 
w_tree_dec_00_hi.alo	Props_temperate.xml 
w_tree_dec_00_cluster.alo	Props_temperate.xml 
w_tree_dec_ns00_cluster.alo	Props_temperate.xml 
w_tree_dec_01_cluster.alo	Props_temperate.xml 
w_tree_dec_ns01_cluster.alo	Props_temperate.xml 
w_tree_dec_00yellow_hi.alo	Props_temperate.xml 
w_tree_dec_00yellow_cluster.alo	Props_temperate.xml 
w_tree_dec_nsyellow_cluster.alo	Props_temperate.xml 
w_tree_dec_01red_hi.alo	Props_temperate.xml 
w_tree_dec_01red_cluster.alo	Props_temperate.xml 
w_tree_dec_nsred_cluster.alo	Props_temperate.xml 
w_treepalm_a.alo	Props_temperate.xml 
w_treepalm_a_cluster.alo	Props_temperate.xml 
w_tree_alien_00_cluster.alo	Props_temperate.xml 
w_grndcvr_b.alo	Props_temperate.xml 
w_grndcvr_c.alo	Props_temperate.xml 
w_grndcvr_d.alo	Props_temperate.xml 
w_grndcvr_felucia.alo	Props_temperate.xml 
w_theedbuild_a.alo	Props_temperate.xml 
w_theedpalace.alo	Props_temperate.xml 
w_waterfallspray_top.alo	Props_temperate.xml 
w_planet_alderaan_high.alo	Props_temperate.xml Spaceprops.xml 
w_paddlewheel.alo	Props_temperate.xml 
w_carpet_cap.alo	Props_urban.xml 
w_urbanblock_a_mission11.alo	Props_urban.xml 
w_urbanblock_b.alo	Props_urban.xml 
w_urbanhalfwall_a.alo	Props_urban.xml 
w_urbanhalfwall_b.alo	Props_urban.xml 
w_urbanhalfwall_side_b.alo	Props_urban.xml 
w_urbanhalfwall_c.alo	Props_urban.xml 
w_urbantraintunnel2.alo	Props_urban.xml 
w_prisonwall.alo	Props_urban.xml 
w_urbanpipes.alo	Props_urban.xml 
w_girder_big.alo	Props_urban.xml 
w_urbansquare_a.alo	Props_urban.xml 
w_urbanpalpstatue.alo	Props_urban.xml 
w_urbanobistatue.alo	Props_urban.xml 
w_urbanoddstatue.alo	Props_urban.xml 
w_urbansquare_b.alo	Props_urban.xml 
w_urbansquare_c.alo	Props_urban.xml 
w_urbansquare_d.alo	Props_urban.xml 
w_urbanwalk_a.alo	Props_urban.xml 
w_urbanstreetlite.alo	Props_urban.xml 
w_urbanwall_a.alo	Props_urban.xml 
w_urbanwall_b.alo	Props_urban.xml 
w_urban_builds_generic00.alo	Props_urban.xml 
w_urban_builds_generic01.alo	Props_urban.xml 
w_urban_builds_generic02.alo	Props_urban.xml 
w_urban_builds_generic03.alo	Props_urban.xml 
w_alderaanbuilding_a.alo	Props_urban.xml 
w_alderaanbuilding_b.alo	Props_urban.xml 
w_alderaanbuilding_c.alo	Props_urban.xml 
w_alderaanbuilding_d.alo	Props_urban.xml 
w_alderaanbuilding_e.alo	Props_urban.xml 
w_urbanshadowtraffic00.alo	Props_urban.xml 
w_urbantraintunnel.alo	Props_urban.xml 
w_urbantraintunnel2_long.alo	Props_urban.xml 
w_urban_corbuild_b.alo	Props_urban.xml 
w_urban_corbuild_c.alo	Props_urban.xml 
w_urban_corbuild_d.alo	Props_urban.xml 
w_urban_corbuild_e.alo	Props_urban.xml 
w_urban_corbuild_f.alo	Props_urban.xml 
w_jeditemple.alo	Props_urban.xml 
w_urban_tarisbuild_a.alo	Props_urban.xml 
w_urban_tarisbuild_b.alo	Props_urban.xml 
w_urbanrailing.alo	Props_urban.xml 
w_kamino_edgewall.alo	Props_urban.xml 
w_kaminobuilding00.alo	Props_urban.xml 
w_kamino_tower_lrg.alo	Props_urban.xml 
w_kamino_tower_sml.alo	Props_urban.xml 
w_kamino_reflect.alo	Props_urban.xml 
w_bespin_building01.alo	Props_urban.xml 
w_bespin_building02.alo	Props_urban.xml 
w_bespin_building03.alo	Props_urban.xml 
w_bespin_fan.alo	Props_urban.xml 
w_gas_collector.alo	Props_urban.xml 
w_volcano_rock02.alo	Props_volcanic.xml 
w_crystals_sullust.alo	Props_volcanic.xml 
w_vol_steam00.alo	Props_volcanic.xml 
w_vol_steam01.alo	Props_volcanic.xml 
cin_heat.alo	Props_volcanic.xml 
w_lava_heat_particle.alo	Props_volcanic.xml 
w_lightbeams_lava.alo	Props_volcanic.xml 
w_geonosis_tower02.alo	Props_volcanic.xml 
w_geonosis_tower03.alo	Props_volcanic.xml 
w_geo_rockcrack01.alo	Props_volcanic.xml 
w_geonosis_rockform01.alo	Props_volcanic.xml 
w_geo_cracksteam.alo	Props_volcanic.xml 
i_minimap_default_click.alo	Radarmap.xml 
i_minimap_attack_move_click.alo	Radarmap.xml 
i_minimap_death_target.alo	Radarmap.xml 
i_minimap_control_point.alo	Radarmap.xml 
i_minimap_beacon.alo	Radarmap.xml 
nb_prison.alo	Secondarystructures.xml Specialstructures.xml 
rb_barracks_small.alo	Secondarystructures.xml 
nb_abandon_mining.alo	Secondarystructures.xml 
nb_piratebase_sml.alo	Secondarystructures.xml 
nb_shuttershieldgen.alo	Secondarystructures.xml Specialstructures.xml 
nb_mercenaryoutfitter.alo	Secondarystructures.xml 
nb_commjamstation.alo	Secondarystructures.xml Specialstructures.xml 
nb_commjamstation_d.alo	Secondarystructures.xml Specialstructures.xml 
nb_spacesensornode.alo	Secondarystructures.xml Specialstructures.xml 
nb_apbase_d.alo	Secondarystructures.xml Starbases.xml 
nv_lds_pad.alo	Spacebuildablesskirmish.xml 
nv_lds_build.alo	Spacebuildablesskirmish.xml 
nv_lrs_build.alo	Spacebuildablesskirmish.xml 
ev_satallite_tb.alo	Spacebuildablesskirmish.xml 
rv_satallite_repair.alo	Spacebuildablesskirmish.xml 
nv_mds_build.alo	Spacebuildablesskirmish.xml 
nv_mds.alo	Spacebuildablesskirmish.xml Specialstructures.xml 
nb_asteroidmining_pad.alo	Spacebuildablesskirmish.xml 
nb_asteroidmining.alo	Spacebuildablesskirmish.xml 
nb_asteroidmining_full.alo	Spacebuildablesskirmish.xml 
w_stars_low.alo	Spaceprimaryskydomes.xml 
w_stars_medium.alo	Spaceprimaryskydomes.xml 
w_stars_high.alo	Spaceprimaryskydomes.xml 
w_stars_maw.alo	Spaceprimaryskydomes.xml 
w_stars_cine.alo	Spaceprimaryskydomes.xml 
w_stars_cine_lua.alo	Spaceprimaryskydomes.xml 
w_planet_balmorra_high.alo	Spaceprops.xml 
w_planet_bonadan_high.alo	Spaceprops.xml 
w_planet_desert00.alo	Spaceprops.xml 
w_planet_urban00.alo	Spaceprops.xml 
w_planet_dagobah_high.alo	Spaceprops.xml 
w_planet_eriadu_high.alo	Spaceprops.xml 
w_planet_forest00.alo	Spaceprops.xml Spaceprops_underworld.xml 
w_planet_gas00.alo	Spaceprops.xml 
w_planet_gas_silver.alo	Spaceprops.xml 
w_planet_geonosis_high.alo	Spaceprops.xml 
w_planet_ice00.alo	Spaceprops.xml 
w_planet_kamino_high.alo	Spaceprops.xml 
w_planet_kessel_high.alo	Spaceprops.xml 
w_planet_kuat_high.alo	Spaceprops.xml 
w_planet_naboo_high.alo	Spaceprops.xml 
w_planet_ocean00.alo	Spaceprops.xml 
w_planet_ryloth_high.alo	Spaceprops.xml 
w_planet_ralltiir_high.alo	Spaceprops.xml 
w_planet_temperate00.alo	Spaceprops.xml 
w_planet_alderaan-urban_high.alo	Spaceprops.xml 
w_planet_volcanic.alo	Spaceprops.xml 
w_planet_wayland_high.alo	Spaceprops.xml 
w_planet_yaviniv_high.alo	Spaceprops.xml 
w_planet_mustafar_high.alo	Spaceprops.xml 
w_planet_utapau_high.alo	Spaceprops.xml 
w_asteroid_mass_huge.alo	Spaceprops.xml 
w_asteroid_mass_huge_particle.alo	Spaceprops.xml 
eb_deathstar_trench_a.alo	Spaceprops.xml 
eb_deathstar_flat_a.alo	Spaceprops.xml 
eb_deathstar_port.alo	Spaceprops.xml 
w_lightning.alo	Spaceprops.xml 
w_asteroid_mass.alo	Spaceprops.xml 
w_asteroid_mass_small.alo	Spaceprops.xml 
w_asteroid_mass_med.alo	Spaceprops.xml 
w_asteroid_mass_blank.alo	Spaceprops.xml 
w_asteroid_mass_med_blank.alo	Spaceprops.xml 
w_nebula03.alo	Spaceprops.xml 
w_nebula00.alo	Spaceprops.xml 
w_nebula01.alo	Spaceprops.xml 
w_nebula02.alo	Spaceprops.xml 
w_nebula04.alo	Spaceprops.xml 
w_nebula03_ion.alo	Spaceprops.xml 
w_nebula00_ion.alo	Spaceprops.xml 
w_nebula01_ion.alo	Spaceprops.xml 
w_nebula02_ion.alo	Spaceprops.xml 
w_nebula04_ion.alo	Spaceprops.xml 
w_black_hole.alo	Spaceprops.xml 
w_spacejunk.alo	Spaceprops.xml 
w_spacejunk_med.alo	Spaceprops.xml 
w_spacejunk_sml.alo	Spaceprops.xml 
nb_apbase_hp_ll2.alo	Spaceprops.xml 
w_planet_deathstar02_ii_chunks.alo	Spaceprops_underworld.xml 
uv_vengeance_hp_rgt_tb.alo	Spaceprops_underworld.xml 
w_stars_nebula_blue.alo	Spacesecondaryskydomes.xml 
w_stars_nebula_steel_blue.alo	Spacesecondaryskydomes.xml 
w_stars_nebula_green.alo	Spacesecondaryskydomes.xml 
w_stars_nebula_green_orange.alo	Spacesecondaryskydomes.xml 
w_stars_nebula_green_orange02.alo	Spacesecondaryskydomes.xml 
w_stars_nebula_orange.alo	Spacesecondaryskydomes.xml 
w_stars_nebula_orange02.alo	Spacesecondaryskydomes.xml 
w_stars_nebula_purple.alo	Spacesecondaryskydomes.xml 
w_stars_nebula_purple02.alo	Spacesecondaryskydomes.xml 
w_stars_nebula_red.alo	Spacesecondaryskydomes.xml 
w_stars_nebula_red_light.alo	Spacesecondaryskydomes.xml 
w_stars_nebula_red_vivid.alo	Spacesecondaryskydomes.xml 
ev_tartancruiser_d.alo	Spaceunitscorvettes.xml 
ev_missile_ship.alo	Spaceunitscorvettes.xml 
rv_corvette_d.alo	Spaceunitscorvettes.xml 
rv_gunship.alo	Spaceunitscorvettes.xml 
rv_gunship_d.alo	Spaceunitscorvettes.xml 
nv_ipv1_d.alo	Spaceunitscorvettes.xml 
ev_missile_ship_d.alo	Spaceunitscorvettes.xml 
rv_missile_ship_d.alo	Spaceunitscorvettes.xml 
nv_shadowclaw.alo	Spaceunitscorvettes.xml 
nv_shadowclaw_d.alo	Spaceunitscorvettes.xml 
rv_corvette_leia.alo	Spaceunitscorvettes.xml 
rv_awing.alo	Spaceunitsfighters.xml Squadrons.xml 
ev_tiescout.alo	Spaceunitsfighters.xml Squadrons.xml 
nv_black_sun_fighter.alo	Spaceunitsfighters.xml 
rv_nebulonb.alo	Spaceunitsfrigates.xml 
rv_nebulonb_d.alo	Spaceunitsfrigates.xml 
rv_nebulonb_d_death_00.alo	Spaceunitsfrigates.xml 
rv_assaultfrigate.alo	Spaceunitsfrigates.xml 
rv_assaultfrigate_d.alo	Spaceunitsfrigates.xml 
ev_victorystardestroyer.alo	Spaceunitsfrigates.xml 
ev_victorystardestroyer_d.alo	Spaceunitsfrigates.xml 
ev_acclamator_d.alo	Spaceunitsfrigates.xml 
ev_interdictor.alo	Spaceunitsfrigates.xml 
ev_interdictor_d.alo	Spaceunitsfrigates.xml 
nv_pirate_frigate.alo	Spaceunitsfrigates.xml 
nv_pirate_frigate_d.alo	Spaceunitsfrigates.xml 
w_planet_deathstar02.alo	Spaceunitssupers.xml 
w_planet_fleet_ds.alo	Spaceunitssupers.xml 
w_hilight_fx.alo	Specialeffects.xml 
w_hilight_fx_small.alo	Specialeffects.xml 
rb_ioncannon.alo	Specialstructures.xml 
w_cantinatat.alo	Specialstructures.xml 
nb_grandarena.alo	Specialstructures.xml 
rb_hypervelocitygun.alo	Specialstructures.xml 
rb_barracks.alo	Specialstructures.xml 
nv_defensesatellite.alo	Specialstructures.xml 
ub_gravcontrolgen.alo	Specialstructures_underworld.xml 
i_rb_station_level1.alo	Starbases.xml 
rb_station_01_break.alo	Starbases.xml 
rb_station_02.alo	Starbases.xml 
i_rb_station_level2.alo	Starbases.xml 
rb_station_02_break.alo	Starbases.xml 
rb_station_03.alo	Starbases.xml 
i_rb_station_level3.alo	Starbases.xml 
rb_station_03_break.alo	Starbases.xml 
rb_station_04.alo	Starbases.xml 
i_rb_station_level4.alo	Starbases.xml 
rb_station_04_break.alo	Starbases.xml 
i_rb_station_level5.alo	Starbases.xml 
rb_station_05_break.alo	Starbases.xml 
i_eb_station_level1.alo	Starbases.xml 
eb_station_break_break_01.alo	Starbases.xml 
eb_station_02.alo	Starbases.xml 
i_eb_station_level2.alo	Starbases.xml 
eb_station_break_break_02.alo	Starbases.xml 
eb_station_03.alo	Starbases.xml 
i_eb_station_level3.alo	Starbases.xml 
eb_station_break_break_03.alo	Starbases.xml 
eb_station_04.alo	Starbases.xml 
i_eb_station_level4.alo	Starbases.xml 
eb_station_break_break_04.alo	Starbases.xml 
eb_station_break_break_05.alo	Starbases.xml 
ub_01_station.alo	Starbases_underworld.xml 
i_ub_01_station.alo	Starbases_underworld.xml 
ub_01_station_d.alo	Starbases_underworld.xml 
ub_02_station.alo	Starbases_underworld.xml 
i_ub_02_station.alo	Starbases_underworld.xml 
ub_02_station_d.alo	Starbases_underworld.xml 
ub_03_station.alo	Starbases_underworld.xml 
i_ub_03_station.alo	Starbases_underworld.xml 
ub_03_station_d.alo	Starbases_underworld.xml 
ub_04_station.alo	Starbases_underworld.xml 
i_ub_04_station.alo	Starbases_underworld.xml 
ub_04_station_d.alo	Starbases_underworld.xml 
ub_05_station.alo	Starbases_underworld.xml 
i_ub_05_station.alo	Starbases_underworld.xml 
ub_05_station_d.alo	Starbases_underworld.xml 
w_textscroll.alo	Starwars3dtextcrawl.xml 
w_textintro.alo	Starwars3dtextcrawl.xml 
ev_imperialcraft.alo	Transportunits.xml 
ev_imperialcraft_space.alo	Transportunits.xml 
ev_imperialcraft_space_d.alo	Transportunits.xml 
ev_at-barge_land.alo	Transportunits.xml 
ev_at-barge_d.alo	Transportunits.xml 
rv_transport_d.alo	Transportunits.xml 
ev_lambdashuttle_space_d.alo	Transportunits.xml 
rv_herotransport.alo	Transportunits.xml 
rv_herotransport_d.alo	Transportunits.xml 
uv_vehtransport_landing.alo	Underworld_transportunits.xml 
uv_vehtransport.alo	Underworld_transportunits.xml 
uv_vehtransport_dc.alo	Underworld_transportunits.xml 
uv_rz-52boardingship_landing.alo	Underworld_transportunits.xml 
uv_rz-52boardingship_d.alo	Underworld_transportunits.xml 
uv_tylander.alo	Underworld_transportunits.xml 
uv_tylander_landing.alo	Underworld_transportunits.xml 
uv_tylander_dc.alo	Underworld_transportunits.xml 
rv_homeone.alo	Uniqueunits.xml 
rv_homeone_d.alo	Uniqueunits.xml 
rv_mfalcon_backwards.alo	Uniqueunits.xml 
rv_mfalcon_d.alo	Uniqueunits.xml 
rv_mfalcon_backwards_d.alo	Uniqueunits.xml 
ev_slave1.alo	Uniqueunits.xml 
ev_slave1_space.alo	Uniqueunits.xml 
ev_slave1_space_d.alo	Uniqueunits.xml 
rv_antilliesvette.alo	Uniqueunits.xml 
rv_antilliesvette_d.alo	Uniqueunits.xml 
nv_jedicruiser_d.alo	Uniqueunits.xml 
nv_swampspeeder.alo	Uniqueunits.xml 
nv_swampspeeder_e.alo	Uniqueunits.xml 
nv_swampspeeder_r.alo	Uniqueunits.xml 
nv_swampspeeder_chew.alo	Uniqueunits.xml 
nv_moldycrow_landing.alo	Uniqueunits.xml 
nv_moldycrow.alo	Uniqueunits.xml 
nv_virago.alo	Uniqueunits.xml Units_space_underworld_starviper.xml 
ev_stardestoyer_thrawn.alo	Units_hero_empire_thrawn.xml 
ev_stardestroyer_thrawn_d.alo	Units_hero_empire_thrawn.xml 
rv_gargantuan.alo	Units_hero_rebel_gargantuan.xml 
rv_gargantuan_dc.alo	Units_hero_rebel_gargantuan.xml 
ri_skywalker.alo	Units_hero_rebel_lukeskywalker.xml 
rv_xwing_landing.alo	Units_hero_rebel_lukeskywalker.xml 
rv_rogue_squad.alo	Units_hero_rebel_rogue_squadron.xml 
ri_yoda.alo	Units_hero_rebel_yoda.xml 
ui_bossk.alo	Units_hero_underworld_bossk.xml 
uv_houndstooth_landing.alo	Units_hero_underworld_bossk.xml 
uv_houndstooth.alo	Units_hero_underworld_bossk.xml 
uv_houndstooth_d.alo	Units_hero_underworld_bossk.xml 
ui_ig88.alo	Units_hero_underworld_ig88.xml 
uv_ig2000_landing.alo	Units_hero_underworld_ig88.xml 
uv_ig2000.alo	Units_hero_underworld_ig88.xml 
uv_ig2000_d.alo	Units_hero_underworld_ig88.xml 
ui_silri.alo	Units_hero_underworld_silri.xml 
ui_tyber.alo	Units_hero_underworld_tyber_zann.xml 
uv_kraytclassdestroyer_tyber.alo	Units_hero_underworld_tyber_zann.xml 
uv_kraytclassdestroyer_d_tyber.alo	Units_hero_underworld_tyber_zann.xml 
ui_urai_fen.alo	Units_hero_underworld_urai_fen.xml 
ei_darktrooper_one.alo	Units_land_empire_darktroopers.xml 
ei_darktrooper_two.alo	Units_land_empire_darktroopers.xml 
ei_darktroop_three.alo	Units_land_empire_darktroopers.xml 
ev_archammer.alo	Units_land_empire_darktroopers.xml 
ev_archammer_d.alo	Units_land_empire_darktroopers.xml 
ev_juggernaut.alo	Units_land_empire_juggernaut.xml 
ev_tie_lancet.alo	Units_land_empire_lancet.xml 
rv_gallofreehtt26.alo	Units_land_rebel_gallofree_htt.xml 
uv_canderousassaulttank.alo	Units_land_underworld_canderous_tank.xml 
ui_droideka.alo	Units_land_underworld_destroyerdroids.xml 
ui_disruptor.alo	Units_land_underworld_disruptorinf.xml 
ui_ewok_handler.alo	Units_land_underworld_ewok_bomber.xml 
ni_ewok_bomb_nohat.alo	Units_land_underworld_ewok_bomber.xml 
uv_f9tztransport.alo	Units_land_underworld_f9tz_transport.xml 
uv_mal.alo	Units_land_underworld_mal.xml 
ui_mercenary.alo	Units_land_underworld_mercenaryinf.xml 
ui_night_sister.alo	Units_land_underworld_nightsister.xml 
uv_mz8mobilepulsecannon.alo	Units_land_underworld_pulsetank.xml 
ui_vornskr.alo	Units_land_underworld_vornskr.xml 
ai_vornskr.alo	Units_land_underworld_vornskr.xml 
ev_executorstardestroyer_d.alo	Units_space_empire_executor.xml 
ev_tie_defender.alo	Units_space_empire_tie_defender.xml 
ev_tie_interceptor.alo	Units_space_empire_tie_interceptor.xml 
ev_tie_phantom.alo	Units_space_empire_tie_phantom.xml 
uv_eclipse_uc.alo	Units_space_neutral_eclipse.xml 
uv_eclipse_uc_dc.alo	Units_space_neutral_eclipse.xml 
uv_eclipse.alo	Units_space_neutral_eclipse.xml 
rv_bwing.alo	Units_space_rebel_bwing.xml 
rv_mc30cmoncal.alo	Units_space_rebel_mc30_frigate.xml 
rv_mc30cmoncal_d.alo	Units_space_rebel_mc30_frigate.xml 
p_b_droids.alo	Units_space_underworld_buzz_droids.xml 
uv_crusaderclasscorvette.alo	Units_space_underworld_crusader_gunship.xml 
uv_crusaderclasscorvette_dc.alo	Units_space_underworld_crusader_gunship.xml 
uv_interceptoriv.alo	Units_space_underworld_interceptor4.xml 
uv_interceptoriv_d.alo	Units_space_underworld_interceptor4.xml 
uv_kedalbebattleship.alo	Units_space_underworld_kadalbe_battleship.xml 
uv_kedalbebattleship_d.alo	Units_space_underworld_kadalbe_battleship.xml 
uv_kraytclassdestroyer.alo	Units_space_underworld_krayt_destroyer.xml 
uv_kraytclassdestroyer_d.alo	Units_space_underworld_krayt_destroyer.xml 
uv_vengeance.alo	Units_space_underworld_vengeance.xml 
uv_vengeance_d.alo	Units_space_underworld_vengeance.xml 
p_rain_med00.alo	Weatherscenarios.xml 
p_snowblizzard.alo	Weatherscenarios.xml 
p_snowsleet.alo	Weatherscenarios.xml 
p_rain_of_ash.alo	Weatherscenarios.xml 
p_dust_storm.alo	Weatherscenarios.xml 
