i_galactic_controls.alo	Commandbarcomponents.xml 
i_galactic_organize.alo	Commandbarcomponents.xml 
i_tactical_controls.alo	Commandbarcomponents.xml 
i_deathstar_switch.alo	Commandbarcomponents.xml 
i_build_buttons.alo	Commandbarcomponents.xml 
i_main_reinforce.alo	Commandbarcomponents.xml 
i_attack_mode_choice.alo	Commandbarcomponents.xml 
i_resolve_mode.alo	Commandbarcomponents.xml 
i_neutralize_hero.alo	Commandbarcomponents.xml 
i_main_hero_frame_rebel.alo	Commandbarcomponents.xml 
i_main_hero_frame_empire.alo	Commandbarcomponents.xml 
i_attack_mode.alo	Commandbarcomponents.xml 
i_attack_mode_single.alo	Commandbarcomponents.xml 
planetary_mode.alo	Commandbarcomponents.xml 
planetary_mode_overlay.alo	Commandbarcomponents.xml 
i_black_market.alo	Commandbarcomponents.xml 
i_sabotage.alo	Commandbarcomponents.xml 
i_corrupt_choice.alo	Commandbarcomponents.xml 
i_hack.alo	Commandbarcomponents.xml 
w_planet_fleet.alo	Containers.xml 
rv_ywing.alo	Containers.xml Groundvehicles.xml Landbombingrununits.xml 
w_waypoint_beacon.alo	Gameconstants.xml 
ri_fieldcommander.alo	Genericherounits.xml Units_hero_rebel_carlist_rieekan.xml Units_hero_rebel_garm_bel_iblis.xml Units_hero_rebel_pharl_mcquarrie.xml Units_hero_rebel_tyr_taskeen.xml Units_land_rebel_troopers.xml 
ri_infantry.alo	Genericherounits.xml Groundcompaniesrebel.xml Groundinfantry.xml Props_story.xml Units_hero_rebel_carlist_rieekan.xml Units_hero_rebel_garm_bel_iblis.xml Units_hero_rebel_pharl_mcquarrie.xml Units_hero_rebel_tyr_taskeen.xml Units_land_rebel_troopers.xml 
ei_fieldcommander.alo	Genericherounits.xml Props_story.xml 
ei_trooper.alo	Genericherounits.xml Groundcompaniesempire.xml Groundinfantry.xml Units_hero_empire_vader.xml Units_land_empire_troopers.xml 
nb_basepad_imperial.alo	Groundbuildablesempire.xml 
nb_repairfacility.alo	Groundbuildablesempire.xml Groundbuildablesrebel.xml Groundturrets.xml 
nb_bactatank.alo	Groundbuildablesempire.xml Groundbuildablesrebel.xml Groundturrets.xml PROPS_YODEN_URBAN.xml 
eb_aaturret.alo	Groundbuildablesempire.xml Groundturrets.xml Props_story.xml 
eb_infantryturret.alo	Groundbuildablesempire.xml Groundturrets.xml PROPS_YODEN_GENERIC.xml 
eb_vehicleturret.alo	Groundbuildablesempire.xml Groundturrets.xml PROPS_YODEN_GENERIC.xml 
nb_sensornode.alo	Groundbuildablesempire.xml Groundbuildablesrebel.xml 
nb_basepad_rebel.alo	Groundbuildablesrebel.xml 
rb_aa-turret.alo	Groundbuildablesrebel.xml Groundturrets.xml 
rb_turret.alo	Groundbuildablesrebel.xml Groundturrets.xml PROPS_YODEN_GENERIC.xml 
rb_vehicleturret.alo	Groundbuildablesrebel.xml Groundturrets.xml PROPS_YODEN_GENERIC.xml 
nb_basepad.alo	Groundbuildablesskirmish.xml Multiplayer_structure_markers.xml 
rb_shield-generator.alo	Groundbuildablesskirmish.xml Markers.xml Multiplayer_structure_markers.xml Specialstructures.xml 
nb_baseshieldgen.alo	Groundbuildablesskirmish.xml Markers.xml Multiplayer_structure_markers.xml Specialstructures.xml 
nb_baseshieldgen_small.alo	Groundbuildablesskirmish.xml Markers.xml Multiplayer_structure_markers.xml Specialstructures.xml 
nb_cmc22mining.alo	Groundbuildablesskirmish.xml Specialstructures.xml Specialstructures_underworld.xml 
eb_tltower.alo	Groundbuildablesskirmish.xml Markers.xml Multiplayer_structure_markers.xml PROPS_YODEN_URBAN.xml Secondarystructures.xml Specialstructures.xml 
eb_governorsquarters.alo	Groundbuildablesskirmish.xml Props_story.xml PROPS_YODEN_STORY.xml PROPS_YODEN_URBAN.xml Specialstructures.xml 
rb_infantrybarracks.alo	Groundbuildablesskirmish.xml Multiplayer_structure_markers.xml Specialstructures.xml 
eb_lightfactory.alo	Groundbuildablesskirmish.xml Specialstructures.xml 
rb_lightvehiclefactory.alo	Groundbuildablesskirmish.xml Multiplayer_structure_markers.xml Specialstructures.xml 
eb_vehiclefactory.alo	Groundbuildablesskirmish.xml Markers.xml Secondarystructures.xml Specialstructures.xml 
rb_heavyvehiclefactory.alo	Groundbuildablesskirmish.xml Markers.xml Multiplayer_structure_markers.xml Secondarystructures.xml Specialstructures.xml 
eb_megaadvancedweapons.alo	Groundbuildablesskirmish.xml Markers.xml Specialstructures.xml 
eb_infantrybarracks.alo	Groundbuildablesskirmish.xml Specialstructures.xml 
rb_officeracademy.alo	Groundbuildablesskirmish.xml PROPS_YODEN_URBAN.xml Specialstructures.xml 
eb_researchfacility.alo	Groundbuildablesskirmish.xml Specialstructures.xml 
rb_researchfacility.alo	Groundbuildablesskirmish.xml Multiplayer_structure_markers.xml Specialstructures.xml 
w_uplink_station.alo	Groundbuildablesskirmish.xml PROPS_YODEN_URBAN.xml Specialstructures.xml 
rb_comcenter.alo	Groundbuildablesskirmish.xml Multiplayer_structure_markers.xml Specialstructures.xml 
eb_commandcenter.alo	Groundbuildablesskirmish.xml Specialstructures.xml 
rb_commandcenter.alo	Groundbuildablesskirmish.xml Multiplayer_structure_markers.xml Specialstructures.xml 
w_pedistal.alo	Groundbuildablesskirmish.xml Markers.xml 
nb_cmc22mining_sml.alo	Groundbuildablesskirmish.xml Specialstructures.xml 
ub_barracks.alo	Groundbuildablesskirmish.xml Specialstructures_underworld.xml 
ub_palace.alo	Groundbuildablesskirmish.xml Specialstructures_underworld.xml 
ub_droidworks.alo	Groundbuildablesskirmish.xml Specialstructures_underworld.xml 
ub_heavyfactory.alo	Groundbuildablesskirmish.xml Specialstructures_underworld.xml 
w_buildbasefoc.alo	Groundbuildablesskirmish.xml 
w_huttpalace.alo	Groundbuildablesskirmish.xml PROPS_YODEN_DESERT.xml Specialstructures.xml 
eb_magnepulsecannon.alo	Groundbuildablesskirmish.xml Specialstructures.xml 
eb_gravcontrolgen.alo	Groundbuildablesskirmish.xml Markers.xml PROPS_YODEN_URBAN.xml Specialstructures.xml 
nb_bunker.alo	Groundbuildablesskirmish.xml Specialstructures_underworld.xml 
eb_testbunker.alo	Groundbuildablesskirmish.xml Specialstructures_underworld.xml 
rb_bunker.alo	Groundbuildablesskirmish.xml Specialstructures_underworld.xml 
ub_bunker.alo	Groundbuildablesskirmish.xml Specialstructures_underworld.xml 
ev_bike.alo	Groundcompaniesempire.xml Groundinfantry.xml 
ri_plexsoldier.alo	Groundcompaniesrebel.xml Groundinfantry.xml Units_land_rebel_troopers.xml 
ei_biker.alo	Groundinfantry.xml Units_land_empire_troopers.xml 
ei_trooper_snow.alo	Groundinfantry.xml Units_hero_empire_malcor_brashin.xml Units_hero_empire_trachta.xml Units_hero_empire_vader.xml Units_land_empire_troopers.xml 
ei_trooper_sand.alo	Groundinfantry.xml Units_land_empire_troopers.xml 
ri_plexs_snow.alo	Groundinfantry.xml 
ri_plexs_desert.alo	Groundinfantry.xml 
ri_plexs_forest.alo	Groundinfantry.xml 
ri_infantry_snow.alo	Groundinfantry.xml Units_land_rebel_troopers.xml 
ri_infantry_desert.alo	Groundinfantry.xml 
ri_infantry_forest.alo	Groundinfantry.xml Units_land_rebel_troopers.xml 
ri_pilot.alo	Groundinfantry.xml 
ri_infiltrator.alo	Groundinfantry.xml Units_hero_rebel_bria_tharen.xml Units_hero_rebel_crix_madine.xml Units_land_rebel_troopers.xml 
ni_piratesoldier.alo	Groundinfantry.xml 
ni_pirateplex.alo	Groundinfantry.xml 
ni_gmale_swamp_a.alo	Groundinfantry.xml 
ni_gmale_urban_a.alo	Groundinfantry.xml 
ei_royalgaurd.alo	Groundinfantry.xml 
w_disruptor_death.alo	Groundinfantry.xml 
w_infect.alo	Groundinfantry.xml 
rv_mdu_shieldgen.alo	Groundturrets.xml 
ub_turretmst50.alo	Groundturrets.xml PROPS_YODEN_GENERIC.xml 
ub_turretptl05.alo	Groundturrets.xml PROPS_YODEN_GENERIC.xml 
uv_mdu_sensor.alo	Groundturrets.xml 
uv_mdu_cage.alo	Groundturrets.xml PROPS_YODEN_URBAN.xml 
uv_mdu_rocket.alo	Groundturrets.xml 
ev_mdu_fieldgen.alo	Groundturrets.xml 
ev_mdu_cgm.alo	Groundturrets.xml 
ev_mdu_sensornode.alo	Groundturrets.xml 
rv_mdu_rflc.alo	Groundturrets.xml 
ev_spmat.alo	Groundvehicles.xml Props_story.xml 
nv_pskiff.alo	Groundvehicles.xml 
nv_pskiff_imperial.alo	Groundvehicles.xml 
nv_pskiff_rebel.alo	Groundvehicles.xml 
nv_pskiff_chew.alo	Groundvehicles.xml 
p_smoke_small02.alo	Groundvehicles.xml Landbombingrununits.xml Particles.xml Units_land_empire_lancet.xml Units_land_rebel_t47.xml Units_land_rebel_v_wing_speeder.xml 
rv_transport.alo	Groundvehicles.xml Transportunits.xml 
w_bespin_collector_droid.alo	Groundvehicles.xml 
ev_stardestroyer_hp00_l-f.alo	Hardpoints.xml Spaceprops.xml 
ev_stardestroyer_hp00_f-r.alo	Hardpoints.xml Spaceprops.xml 
ev_stardestroyer_hp00_b-l.alo	Hardpoints.xml Spaceprops.xml 
ev_stardestroyer_hp00_b-r.alo	Hardpoints.xml Spaceprops.xml 
ev_stardestroyer_hp00_m-l.alo	Hardpoints.xml 
ev_stardestroyer_hp00_m-r.alo	Hardpoints.xml 
ev_stardestroyer_hp00_m-c.alo	Hardpoints.xml Spaceprops.xml 
ev_stardestroyer_hp00_e.alo	Hardpoints.xml 
rv_moncalcruiser_hp00_f-l.alo	Hardpoints.xml Spaceprops.xml 
rv_moncalcruiser_hp00_f-r.alo	Hardpoints.xml Spaceprops.xml 
rv_moncalcruiser_hp00_b-l.alo	Hardpoints.xml Spaceprops.xml 
rv_moncalcruiser_hp00_b-r.alo	Hardpoints.xml Spaceprops.xml 
rv_moncalcruiser_hp00_m-l.alo	Hardpoints.xml Spaceprops.xml 
rv_moncalcruiser_hp00_m-r.alo	Hardpoints.xml Spaceprops.xml 
rv_moncalcruiser_hp00_e.alo	Hardpoints.xml 
ev_interdictor_hp00_f-l.alo	Hardpoints.xml Spaceprops.xml 
ev_interdictor_hp00_f-r.alo	Hardpoints.xml Spaceprops.xml 
ev_interdictor_hp00_b-l.alo	Hardpoints.xml Spaceprops.xml 
ev_interdictor_hp00_b-r.alo	Hardpoints.xml Spaceprops.xml 
ev_interdictor_hp00_c-m.alo	Hardpoints.xml 
ev_interdictor_hp00_c-b.alo	Hardpoints.xml 
ev_interdictor_hp00_e.alo	Hardpoints.xml 
rv_homeone_hp_shg.alo	Hardpoints.xml Spaceprops.xml 
rv_homeone_hp_tbl_bl.alo	Hardpoints.xml Spaceprops.xml 
rv_homeone_hp_tbl_br.alo	Hardpoints.xml Spaceprops.xml 
rv_homeone_hp_tbl_fl.alo	Hardpoints.xml Spaceprops.xml 
rv_homeone_hp_tbl_fr.alo	Hardpoints.xml Spaceprops.xml 
rv_homeone_hp_ic_bl.alo	Hardpoints.xml Spaceprops.xml 
rv_homeone_hp_ic_br.alo	Hardpoints.xml Spaceprops.xml 
rv_homeone_hp_ic_fl.alo	Hardpoints.xml Spaceprops.xml 
rv_homeone_hp_ic_fr.alo	Hardpoints.xml Spaceprops.xml 
eb_station_01_hp01_cm.alo	Hardpoints.xml HardPoints_Starbases.xml Spaceprops.xml 
eb_station_01_hp01_lc.alo	Hardpoints.xml HardPoints_Starbases.xml Spaceprops.xml 
eb_station_01_hp01_tbl.alo	Hardpoints.xml HardPoints_Starbases.xml Spaceprops.xml 
eb_station_01_hp01_shg.alo	Hardpoints.xml HardPoints_Starbases.xml Spaceprops.xml 
nv_pirate_frigate_hp00_f.alo	Hardpoints.xml Spaceprops.xml 
nv_pirate_frigate_hp00_b-l.alo	Hardpoints.xml Spaceprops.xml 
nv_pirate_frigate_hp00_b-r.alo	Hardpoints.xml Spaceprops.xml 
nb_apbase_hp_ll1.alo	Hardpoints.xml Spaceprops.xml 
nb_apbase_hp_tl1.alo	Hardpoints.xml Spaceprops.xml 
nb_apbase_hp_tl2.alo	Hardpoints.xml Spaceprops.xml 
nb_apbase_hp_tl3.alo	Hardpoints.xml Spaceprops.xml 
nb_apbase_hp_tl4.alo	Hardpoints.xml Spaceprops.xml 
nb_apbase_hp_ht1.alo	Hardpoints.xml Spaceprops.xml 
nb_apbase_hp_ht2.alo	Hardpoints.xml Spaceprops.xml 
nb_apbase_hp_shg.alo	Hardpoints.xml Spaceprops.xml 
nb_apbase_hp_hb.alo	Hardpoints.xml Spaceprops.xml 
imperial_i-class_star_destroyer_hdti_00.alo	HardPoints_Capital.xml 
imperial_i-class_star_destroyer_hdti_01.alo	HardPoints_Capital.xml 
imperial_i-class_star_destroyer_hdtl_00.alo	HardPoints_Capital.xml 
imperial_i-class_star_destroyer_hdtl_01.alo	HardPoints_Capital.xml 
imperial_i-class_star_destroyer_hdtl_02.alo	HardPoints_Capital.xml 
imperial_i-class_star_destroyer_hdtl_03.alo	HardPoints_Capital.xml 
imperial_i-class_star_destroyer_hdtl_04.alo	HardPoints_Capital.xml 
imperial_i-class_star_destroyer_hdtl_05.alo	HardPoints_Capital.xml 
imperial_ii-class_star_destroyer_hoti_00.alo	HardPoints_Capital.xml 
imperial_ii-class_star_destroyer_hoti_01.alo	HardPoints_Capital.xml 
imperial_ii-class_star_destroyer_hotl_00.alo	HardPoints_Capital.xml 
imperial_ii-class_star_destroyer_hotl_01.alo	HardPoints_Capital.xml 
imperial_ii-class_star_destroyer_hotl_02.alo	HardPoints_Capital.xml 
imperial_ii-class_star_destroyer_hotl_03.alo	HardPoints_Capital.xml 
imperial_ii-class_star_destroyer_hotl_04.alo	HardPoints_Capital.xml 
imperial_ii-class_star_destroyer_hotl_05.alo	HardPoints_Capital.xml 
strident_turret12.alo	HardPoints_Capital.xml 
strident_turret13.alo	HardPoints_Capital.xml 
strident_turret14.alo	HardPoints_Capital.xml 
strident_turret15.alo	HardPoints_Capital.xml 
venator-class_star_destroyer_hdtl_00.alo	HardPoints_Capital.xml 
venator-class_star_destroyer_hdtl_01.alo	HardPoints_Capital.xml 
venator-class_star_destroyer_hdtl_02.alo	HardPoints_Capital.xml 
venator-class_star_destroyer_hdtl_03.alo	HardPoints_Capital.xml 
venator-class_star_destroyer_hdtl_04.alo	HardPoints_Capital.xml 
venator-class_star_destroyer_hdtl_05.alo	HardPoints_Capital.xml 
venator-class_star_destroyer_hdtl_06.alo	HardPoints_Capital.xml 
venator-class_star_destroyer_hdtl_07.alo	HardPoints_Capital.xml 
rv_assaultfrigate_hp00_f-l.alo	HardPoints_Frigates.xml Spaceprops.xml 
rv_assaultfrigate_hp00_f-r.alo	HardPoints_Frigates.xml Spaceprops.xml 
rv_assaultfrigate_hp00_b-l.alo	HardPoints_Frigates.xml Spaceprops.xml 
rv_assaultfrigate_hp00_b-r.alo	HardPoints_Frigates.xml Spaceprops.xml 
rv_assaultfrigate_hp00_e.alo	HardPoints_Frigates.xml 
yt-1300_light_freighter_ql.alo	HardPoints_Heroes.xml 
yt-1300_light_freighter_rectenna.alo	HardPoints_Heroes.xml 
px-10_compact_assault_vehicle_b.alo	HardPoints_Land.xml 
ev_at_aa_turret.alo	HardPoints_Land.xml 
qh-7_chariot_light_assault_vehicle_l.alo	HardPoints_Land.xml 
ev_s1_firehawke_00.alo	HardPoints_Land.xml 
ev_s1_firehawke_01.alo	HardPoints_Land.xml 
century_tank_ltl.alo	HardPoints_Land.xml 
ev_a9_floating_fortress_turret_l.alo	HardPoints_Land.xml 
ev_a9_floating_fortress_turret_r.alo	HardPoints_Land.xml 
rv_ulav_turret_01.alo	HardPoints_Land.xml 
arrow-23_landspeeder_l.alo	HardPoints_Land.xml 
arrow-23_landspeeder_g.alo	HardPoints_Land.xml 
armored_freerunner_dl.alo	HardPoints_Land.xml 
armored_freerunner_b_01.alo	HardPoints_Land.xml 
armored_freerunner_b_02.alo	HardPoints_Land.xml 
rv_t-1b_00.alo	HardPoints_Land.xml 
rv_t-1b_01.alo	HardPoints_Land.xml 
rv_t2_b_00.alo	HardPoints_Land.xml 
rv_t3-b_00.alo	HardPoints_Land.xml 
rv_t4_b_00.alo	HardPoints_Land.xml 
heavy_tracker_hl.alo	HardPoints_Land.xml 
a-a5_speeder_truck_l.alo	HardPoints_Land.xml 
a-a5_speeder_truck_g.alo	HardPoints_Land.xml 
sv_armored_assault_tank_00.alo	HardPoints_Land.xml 
sv_armored_assault_tank_01.alo	HardPoints_Land.xml 
eb_station_01_hp01_ca.alo	HardPoints_Starbases.xml Spaceprops.xml 
eb_station_02_hp02_lc.alo	HardPoints_Starbases.xml Spaceprops.xml 
eb_station_02_hp02_prt.alo	HardPoints_Starbases.xml Spaceprops.xml 
eb_station_02_hp02_tbl.alo	HardPoints_Starbases.xml Spaceprops.xml 
eb_station_03_hp03_cm.alo	HardPoints_Starbases.xml Spaceprops.xml 
eb_station_03_hp03_ic.alo	HardPoints_Starbases.xml Spaceprops.xml 
eb_station_03_hp03_prt.alo	HardPoints_Starbases.xml Spaceprops.xml 
eb_station_04_hp04_ic.alo	HardPoints_Starbases.xml Spaceprops.xml 
eb_station_04_hp04_lc.alo	HardPoints_Starbases.xml 
eb_station_04_hp04_tbl.alo	HardPoints_Starbases.xml Spaceprops.xml 
eb_station_05_hp05_cm.alo	HardPoints_Starbases.xml Spaceprops.xml 
eb_station_05_hp05_ic.alo	HardPoints_Starbases.xml Spaceprops.xml 
eb_station_05_hp05_prt.alo	HardPoints_Starbases.xml Spaceprops.xml 
eb_station_05_hp05_tbl.alo	HardPoints_Starbases.xml Spaceprops.xml 
rb_station_01_hp01_ca.alo	HardPoints_Starbases.xml PROPS_YODEN_GENERIC.xml Spaceprops.xml 
rb_station_01_hp01_shg.alo	HardPoints_Starbases.xml Spaceprops.xml 
rb_station_01_hp01_ccm.alo	HardPoints_Starbases.xml 
rb_station_01_hp01_lc.alo	HardPoints_Starbases.xml 
rb_station_01_hp01_tbl.alo	HardPoints_Starbases.xml Spaceprops.xml 
rb_station_02_hp02_lc.alo	HardPoints_Starbases.xml Spaceprops.xml 
rb_station_02_hp02_prt.alo	HardPoints_Starbases.xml 
rb_station_02_hp02_tbl.alo	HardPoints_Starbases.xml Spaceprops.xml 
rb_station_03_hp03_ccm.alo	HardPoints_Starbases.xml 
rb_station_03_hp03_ic.alo	HardPoints_Starbases.xml Spaceprops.xml 
rb_station_03_hp03_prt.alo	HardPoints_Starbases.xml Spaceprops.xml 
rb_station_04_hp04_ic.alo	HardPoints_Starbases.xml Spaceprops.xml 
rb_station_04_hp04_lc.alo	HardPoints_Starbases.xml Spaceprops.xml 
rb_station_04_hp04_tbl.alo	HardPoints_Starbases.xml PROPS_YODEN_URBAN.xml Spaceprops.xml 
rb_station_04_hp04_shg.alo	HardPoints_Starbases.xml Spaceprops.xml 
rb_station_05_hp05_ccm.alo	HardPoints_Starbases.xml Spaceprops.xml 
rb_station_05_hp05_ic.alo	HardPoints_Starbases.xml Spaceprops.xml 
rb_station_05_hp05_prt.alo	HardPoints_Starbases.xml Spaceprops.xml 
rb_station_05_hp05_tbl.alo	HardPoints_Starbases.xml Spaceprops.xml 
rb_station_05_hp05_tbl2.alo	HardPoints_Starbases.xml Spaceprops.xml 
ev_executorstardestroyer_hp_l_trb00.alo	HardPoints_underworld.xml 
ev_executorstardestroyer_hp_l_trb01.alo	HardPoints_underworld.xml 
ev_executorstardestroyer_hp_l_trb02.alo	HardPoints_underworld.xml 
ev_executorstardestroyer_hp_l_trb03.alo	HardPoints_underworld.xml 
ev_executorstardestroyer_hp_l_trb04.alo	HardPoints_underworld.xml 
ev_executorstardestroyer_hp_l_ion00.alo	HardPoints_underworld.xml 
ev_executorstardestroyer_hp_l_ion01.alo	HardPoints_underworld.xml 
ev_executorstardestroyer_hp_l_ion02.alo	HardPoints_underworld.xml 
ev_executorstardestroyer_hp_l_conm00.alo	HardPoints_underworld.xml 
ev_executorstardestroyer_hp_l_conm01.alo	HardPoints_underworld.xml 
ev_executorstardestroyer_hp_l_torp.alo	HardPoints_underworld.xml 
ev_executorstardestroyer_hp_r_trb00.alo	HardPoints_underworld.xml 
ev_executorstardestroyer_hp_r_trb01.alo	HardPoints_underworld.xml 
ev_executorstardestroyer_hp_r_trb02.alo	HardPoints_underworld.xml 
ev_executorstardestroyer_hp_r_trb03.alo	HardPoints_underworld.xml 
ev_executorstardestroyer_hp_r_trb04.alo	HardPoints_underworld.xml 
ev_executorstardestroyer_hp_r_ion00.alo	HardPoints_underworld.xml 
ev_executorstardestroyer_hp_r_ion01.alo	HardPoints_underworld.xml 
ev_executorstardestroyer_hp_r_ion02.alo	HardPoints_underworld.xml 
ev_executorstardestroyer_hp_r_conm00.alo	HardPoints_underworld.xml 
ev_executorstardestroyer_hp_r_torp.alo	HardPoints_underworld.xml 
ev_executorstardestroyer_hp_m_torp.alo	HardPoints_underworld.xml 
ev_executorstardestroyer_hp_trac.alo	HardPoints_underworld.xml 
ev_executorstardestroyer_hp_shld00.alo	HardPoints_underworld.xml 
ev_executorstardestroyer_hp_shld01.alo	HardPoints_underworld.xml 
ev_executorstardestroyer_hp_shld02.alo	HardPoints_underworld.xml 
ev_executorstardestroyer_hp_e.alo	HardPoints_underworld.xml 
ev_executorstardestroyer_hp_e2.alo	HardPoints_underworld.xml 
uv_interceptoriv_hp00_f.alo	HardPoints_underworld.xml 
uv_interceptoriv_hp00_b-l.alo	HardPoints_underworld.xml 
uv_interceptoriv_hp00_b-r.alo	HardPoints_underworld.xml 
uv_kraytclassdestroyer_hp_ion_00.alo	HardPoints_underworld.xml 
uv_kraytclassdestroyer_hp_sw_00.alo	HardPoints_underworld.xml 
uv_kraytclassdestroyer_hp_lc_l_00.alo	HardPoints_underworld.xml 
uv_kraytclassdestroyer_hp_lc_l_00_tyber.alo	HardPoints_underworld.xml 
uv_kraytclassdestroyer_hp_lc_r_00.alo	HardPoints_underworld.xml 
uv_kraytclassdestroyer_hp_lc_r_00_tyber.alo	HardPoints_underworld.xml 
uv_kraytclassdestroyer_hp_shld_00.alo	HardPoints_underworld.xml 
uv_vengeance_hp_lft_mdc.alo	HardPoints_underworld.xml 
uv_vengeance_hp_rgt_mdc.alo	HardPoints_underworld.xml 
uv_vengeance_hp_lft_tb.alo	HardPoints_underworld.xml 
uv_kedalbebattleship_hp_tb_lft_00.alo	HardPoints_underworld.xml 
uv_kedalbebattleship_hp_tb_lft_01.alo	HardPoints_underworld.xml 
uv_kedalbebattleship_hp_tb_rgt_00.alo	HardPoints_underworld.xml 
uv_kedalbebattleship_hp_tb_rgt_01.alo	HardPoints_underworld.xml 
uv_kedalbebattleship_hp_ion_lft_00.alo	HardPoints_underworld.xml 
uv_kedalbebattleship_hp_ion_rgt_00.alo	HardPoints_underworld.xml 
uv_kedalbebattleship_hp_mdb_frnt_00.alo	HardPoints_underworld.xml 
uv_kedalbebattleship_hp_shl_00.alo	HardPoints_underworld.xml 
ub_01_station_hp01_com.alo	HardPoints_underworld.xml 
ub_01_station_hp01_shg.alo	HardPoints_underworld.xml 
ub_03_station_hp03_pt.alo	HardPoints_underworld.xml 
ub_03_station_hp03_gun.alo	HardPoints_underworld.xml 
ub_04_station_hp04_pc.alo	HardPoints_underworld.xml 
ub_05_station_hp05_ic.alo	HardPoints_underworld.xml 
ub_05_station_hp05_pt.alo	HardPoints_underworld.xml 
ub_05_station_hp05_tbl.alo	HardPoints_underworld.xml 
hp_leftshieldgen_00.alo	HardPoints_underworld.xml 
hp_rightshieldgen_00.alo	HardPoints_underworld.xml 
hp_turret_front_00.alo	HardPoints_underworld.xml 
hp_turret_back_00.alo	HardPoints_underworld.xml 
hp_turret_front_l_00.alo	HardPoints_underworld.xml 
hp_turret_front_r_00.alo	HardPoints_underworld.xml 
hp_turret_back_l_00.alo	HardPoints_underworld.xml 
hp_turret_back_r_00.alo	HardPoints_underworld.xml 
ub_palace_hp_gen.alo	HardPoints_underworld.xml 
ub_palace_hp_comm.alo	HardPoints_underworld.xml 
ev_stardestroyer_thrawn_hp00_l-f.alo	HardPoints_underworld.xml 
ev_stardestroyer_thrawn_hp00_f-r.alo	HardPoints_underworld.xml 
ev_stardestroyer_thrawn_hp00_b-l.alo	HardPoints_underworld.xml 
ev_stardestroyer_thrawn_hp00_b-r.alo	HardPoints_underworld.xml 
ev_stardestroyer_thrawn_hp00_m-l.alo	HardPoints_underworld.xml 
ev_stardestroyer_thrawn_hp00_m-r.alo	HardPoints_underworld.xml 
ev_stardestroyer_thrawn_hp00_m-c.alo	HardPoints_underworld.xml 
ev_stardestroyer_thrawn_hp00_e.alo	HardPoints_underworld.xml 
ev_tiebomber.alo	Landbombingrununits.xml Props_story.xml Spaceunitsfighters.xml Squadrons.xml 
scimitar_assault_bomber.alo	Landbombingrununits.xml Units_space_empire_tie_scimitar.xml 
uv_skipray.alo	Landbombingrununits.xml 
w_stars_greenscreen.alo	Landprimaryskydomes.xml SpacePrimarySkydomes.xml 
w_stars_blackscreen.alo	Landprimaryskydomes.xml SpacePrimarySkydomes.xml 
w_stars_purplescreen.alo	Landprimaryskydomes.xml SpacePrimarySkydomes.xml 
w_sky00.alo	Landprimaryskydomes.xml 
w_sky00_evening.alo	Landprimaryskydomes.xml 
w_sky_murk00.alo	Landprimaryskydomes.xml 
w_sky_murk00_huge.alo	Landprimaryskydomes.xml 
w_skysnow00.alo	Landprimaryskydomes.xml 
w_sky_desert00.alo	Landprimaryskydomes.xml 
w_skyclear00.alo	Landprimaryskydomes.xml 
w_sky_storm00.alo	Landprimaryskydomes.xml 
w_sky_desert00_evening.alo	Landprimaryskydomes.xml 
w_sky_nightclear00.alo	Landprimaryskydomes.xml 
w_sky_nightclear00_noflare.alo	Landprimaryskydomes.xml 
w_sky_thin_atmos00.alo	Landprimaryskydomes.xml 
w_sky_volcanic00.alo	Landprimaryskydomes.xml 
w_sky_smog00.alo	Landprimaryskydomes.xml Props_story.xml 
w_sky_bespin.alo	Landprimaryskydomes.xml SpaceSecondarySkydomes.xml 
w_sky_interior.alo	Landprimaryskydomes.xml 
w_sky_interior2.alo	Landprimaryskydomes.xml 
w_sky_kamino.alo	Landprimaryskydomes.xml 
w_sky_utapau.alo	Landprimaryskydomes.xml 
w_flag_marker_green.alo	Markers.xml 
w_flag_marker_blue.alo	Markers.xml 
nb_piratebase_01.alo	Markers.xml Specialstructures.xml 
nv_lrs.alo	Markers.xml Spacebuildablesskirmish.xml Specialstructures.xml 
rb_station_05.alo	Markers.xml Starbases.xml 
w_flag_marker_white.alo	Markers.xml Miscobjects.xml Props_story.xml 
w_flag_marker_yellow.alo	Markers.xml 
w_flag_marker_red.alo	Markers.xml Miscobjects.xml 
w_planet_deathstar.alo	Markers.xml 
w_pedistal_faction.alo	Markers.xml 
w_pedistal_faction_1.alo	Markers.xml 
w_pedistal_faction_2.alo	Markers.xml 
w_pedistal_faction_3.alo	Markers.xml 
w_pedistal_faction_4.alo	Markers.xml 
w_pedistal_faction_5.alo	Markers.xml 
w_pedistal_faction_10.alo	Markers.xml 
w_pedistal_rebel.alo	Markers.xml Multiplayer_structure_markers.xml 
w_pedistal_imperial.alo	Markers.xml Props_story.xml 
w_pedistal_underworld.alo	Markers.xml 
w_flag_marker_purple.alo	Markers.xml 
w_smallbomb.alo	Miscobjects.xml Projectiles.xml Projectiles_Infantry.xml Props_story.xml 
w_pick_up_coins.alo	Miscobjects.xml Particles.xml 
i_multiplayer_beacon.alo	Miscobjects.xml 
p_contamination_cloud.alo	Miscobjects.xml 
w_landmine_oldbf2.alo	Miscobjects.xml 
w_laser_invisible.alo	Miscobjects.xml Particles.xml Projectiles.xml Projectiles_Infantry.xml Projectiles_SM.xml Upgradeobjects_underworld.xml 
mdp_00.alo	Mobile_defense_units.xml 
uv_mdu.alo	Mobile_defense_units.xml 
ev_mdu.alo	Mobile_defense_units.xml 
rv_mdu.alo	Mobile_defense_units.xml 
eb_station_01.alo	Multiplayer_structure_markers.xml Starbases.xml 
rb_station_01.alo	Multiplayer_structure_markers.xml Starbases.xml 
ei_bobafett.alo	Namedherounits.xml 
ei_palpatine.alo	Namedherounits.xml 
ei_marajade.alo	Namedherounits.xml 
ri_obiwan.alo	Namedherounits.xml 
ri_r2.alo	Namedherounits.xml 
ri_c3po.alo	Namedherounits.xml 
p_shocked_inf.alo	Particles.xml 
p_b_droids.alo	Particles.xml 
p_infantry_cspl_12.alo	Particles.xml 
p_explosion_tiny.alo	Particles.xml 
p_explosion_empire_tiny.alo	Particles.xml 
p_mouse_click.alo	Particles.xml 
p_mouse_double_click.alo	Particles.xml 
p_mouse_click_attack.alo	Particles.xml 
p_mouse_guard.alo	Particles.xml 
p_shield_penetration_generic.alo	Particles.xml 
p_dirt_emitter_test1.alo	Particles.xml 
test_rain.alo	Particles.xml 
p_lava_bubbles.alo	Particles.xml 
p_hover_generic.alo	Particles.xml 
p_steam_small01.alo	Particles.xml 
p_explosion_small00.alo	Particles.xml 
p_explosion_empire_small00.alo	Particles.xml 
p_explosion_med00.alo	Particles.xml 
p_explosion_empire_med00.alo	Particles.xml 
p_explosion_big00.alo	Particles.xml 
p_explosion_empire_big00.alo	Particles.xml 
p_explosion_empire_big01.alo	Particles.xml 
p_explosion_huge00.alo	Particles.xml 
p_explosion_friggin_huge00.alo	Particles.xml 
p_explosion_empire_friggin_huge00.alo	Particles.xml 
p_explosion_empire_huge00.alo	Particles.xml 
p_explosion_empire_huge00_no_debris.alo	Particles.xml 
p_explosion_small01.alo	Particles.xml Projectiles_Land.xml 
p_explosion_missile_ground01.alo	Particles.xml 
p_explosion_thermal_empire.alo	Particles.xml 
p_explosion_thermal_underworld.alo	Particles.xml 
p_explosion_thermal_rebel.alo	Particles.xml 
p_seismic_explosion00.alo	Particles.xml 
p_explosion_med01.alo	Particles.xml 
p_explosion_big01.alo	Particles.xml 
p_sab_bomb.alo	Particles.xml 
p_ewok_suicide.alo	Particles.xml 
p_explosion_atat01.alo	Particles.xml 
p_explosion_huge01.alo	Particles.xml 
p_damage_small00.alo	Particles.xml 
p_damage_med00.alo	Particles.xml 
p_damage_big00.alo	Particles.xml 
p_spmat_splash.alo	Particles.xml 
p_self_destruct_effect.alo	Particles.xml 
p_weaken_enemy_detonation_effect.alo	Particles.xml 
p_explosion_tiny00_dud.alo	Particles.xml 
p_explosion_med00_dud.alo	Particles.xml 
p_desert_ground_puff.alo	Particles.xml 
p_shield_blast_small00.alo	Particles.xml 
p_shield_blast_med00.alo	Particles.xml 
p_shield_blast_large01.alo	Particles.xml 
p_shield_large01.alo	Particles.xml 
p_explosion_empire_med00_no_debris.alo	Particles.xml 
p_ataa_footpuff_default.alo	Particles.xml 
p_atat_footpuff_dirt.alo	Particles.xml 
p_splash_wake.alo	Particles.xml 
p_atat_footpuff_grass.alo	Particles.xml 
p_atat_footpuff_snow.alo	Particles.xml 
p_explosion_thermal_small00.alo	Particles.xml 
p_explosion_flak01.alo	Particles.xml 
p_rain_splash.alo	Particles.xml 
p_splash_bullet.alo	Particles.xml 
p_splash_wake_continuous.alo	Particles.xml 
p_splash_wake_lava.alo	Particles.xml 
p_ice_ground_puff.alo	Particles.xml 
p_landing_dust_temperate.alo	Particles.xml 
p_landing_dust_snow.alo	Particles.xml 
p_landing_dust_desert.alo	Particles.xml 
p_landing_dust_forest.alo	Particles.xml 
p_landing_dust_swamp.alo	Particles.xml 
p_landing_dust_volcanic.alo	Particles.xml 
p_landing_dust_urban.alo	Particles.xml 
p_magnespulse_buildup.alo	Particles.xml 
p_magna_explosion.alo	Particles.xml 
p_magnepulse_damage00.alo	Particles.xml 
p_heal00.alo	Particles.xml 
p_force_distract.alo	Particles.xml 
p_stun_fx.alo	Particles.xml 
p_corrupt_fx.alo	Particles.xml 
p_tani_stun.alo	Particles.xml 
p_instant_heal.alo	Particles.xml 
p_force_push.alo	Particles.xml 
p_force_whirlwind.alo	Particles.xml 
p_force_convert.alo	Particles.xml 
p_lure_object_particle_effect.alo	Particles.xml 
p_canderous_lure.alo	Particles.xml 
p_at-at_powerup.alo	Particles.xml 
p_piet_powerup.alo	Particles.xml 
p_replenish_wingmen_particle_effect.alo	Particles.xml 
p_weaken_enemy_particle_effect.alo	Particles.xml 
p_telekenesis_attack.alo	Particles.xml 
p_home_one_target.alo	Particles.xml 
p_stealing.alo	Particles.xml 
p_smoke_small01.alo	Particles.xml 
p_smoke_small00.alo	Particles.xml 
p_smoke_med01.alo	Particles.xml 
p_smoke_med00.alo	Particles.xml 
p_smoke_big01.alo	Particles.xml 
p_smoke_big00.alo	Particles.xml 
p_shield_small01.alo	Particles.xml 
p_shield_med01.alo	Particles.xml 
p_bothan_stun_explosion.alo	Particles.xml 
p_dazed.alo	Particles.xml 
p_invulnerable00.alo	Particles.xml 
p_planet_explode_300.alo	Particles.xml 
p_fire_small00.alo	Particles.xml 
p_fire_med00.alo	Particles.xml 
p_fire_big00.alo	Particles.xml 
p_fire_huge00.alo	Particles.xml 
p_fire_empire_small00.alo	Particles.xml 
p_fire_empire_med00.alo	Particles.xml 
p_fire_empire_big00.alo	Particles.xml 
p_fire_empire_huge00.alo	Particles.xml 
p_girder_dust_med00.alo	Particles.xml 
p_antilles_rescue.alo	Particles.xml 
p_fire_med01.alo	Particles.xml 
p_planet_corrupt.alo	Particles.xml 
p_planet_corrupt_large.alo	Particles.xml 
p_planet_corrupt2.alo	Particles.xml 
p_greenglow.alo	Particles.xml Projectiles.xml 
p_blueglow.alo	Particles.xml 
p_e_orbital_blast.alo	Particles.xml 
p_r_orbital_blast.alo	Particles.xml 
p_kraytdestoyer_detonate.alo	Particles.xml 
p_detonate_friggin_huge00_backup3_special.alo	Particles.xml 
p_orbital_impact_emit4.alo	Particles.xml 
p_orbital_impact_ionburst.alo	Particles.xml 
--p_orbital_impact_ion.alo	Particles.xml 
p_force_confuse.alo	Particles.xml 
w_bribery_credit.alo	Particles.xml 
p_corrupt_bribery.alo	Particles.xml 
p_buildup.alo	Particles.xml 
p_pulse_self_destruct_effect.alo	Particles.xml 
p_heat_pulsetank.alo	Particles.xml 
p_urai_poison.alo	Particles.xml 
p_leech_shield.alo	Particles.xml 
p_garg_flare.alo	Particles.xml 
p_rancor_summon.alo	Particles.xml 
p_corrupt_ship.alo	Particles.xml 
p_mind_trick.alo	Particles.xml 
p_corrupt_system.alo	Particles.xml 
p_carbonite_explosion.alo	Particles.xml 
p_sensorjammer.alo	Particles.xml 
p_tybergun.alo	Particles.xml 
p_ri_engineer_cannon.alo	Particles.xml 
p_flame_rifle.alo	Particles.xml 
p_plasma_burn.alo	Particles.xml 
p_nullified_force.alo	Particles.xml 
p_repulsor_snare.alo	Particles.xml 
p_explosion_galactic_underworld.alo	Particles.xml 
w_galaxy00.alo	Planets.xml 
w_planet_temperate01.alo	Planets.xml 
w_planet_asteroids.alo	Planets.xml 
w_planet_volcanic01.alo	Planets.xml 
w_planet_alderaan_low.alo	Planets.xml 
w_planet_forest01.alo	Planets.xml 
w_planet_ice01.alo	Planets.xml 
w_planet_swamp01.alo	Planets.xml 
w_planet_gas01.alo	Planets.xml 
w_planet_ocean01.alo	Planets.xml 
w_planet_bonadan_low.alo	Planets.xml 
w_planet_urban01.alo	Planets.xml 
w_planet_dagobah_low.alo	Planets.xml 
w_planet_dantooine01.alo	Planets.xml 
w_planet_endor_low.alo	Planets.xml 
w_planet_eriadu_low.alo	Planets.xml 
w_planet_geonosis_low.alo	Planets.xml 
w_planet_desert01.alo	Planets.xml 
w_planet_hoth_low.alo	Planets.xml 
w_planet_kamino_low.alo	Planets.xml 
w_planet_kessel_low.alo	Planets.xml 
w_planet_korriban01.alo	Planets.xml 
w_planet_kuat_low.alo	Planets.xml 
w_planet_moncalamari01.alo	Planets.xml 
w_planet_naboo_low.alo	Planets.xml 
w_planet_nalhutta01.alo	Planets.xml 
w_planet_ryloth_low.alo	Planets.xml 
w_planet_taris01.alo	Planets.xml 
w_planet_tatooine_low.alo	Planets.xml 
w_black_hole_small.alo	Planets.xml 
w_planet_thyferra01.alo	Planets.xml 
w_planet_utapau_low.alo	Planets.xml 
w_planet_wayland_low.alo	Planets.xml 
w_planet_yaviniv_low.alo	Planets.xml 
w_proton_projectile.alo	Projectiles.xml 
pion_ioncannonshot.alo	Projectiles.xml 
w_laser_small.alo	Projectiles.xml Projectiles_Infantry.xml Projectiles_SM.xml 
w_laser_smallg.alo	Projectiles.xml 
w_laser_medium.alo	Projectiles.xml 
p_lucky.alo	Projectiles.xml 
w_laser_mediumg.alo	Projectiles.xml 
w_laser_largeg.alo	Projectiles.xml 
w_concussion_missile.alo	Projectiles.xml 
ri_saber_spin.alo	Projectiles.xml Props_story.xml PROPS_YODEN_STORY.xml 
w_ewok_rock.alo	Projectiles.xml 
w_gungan_projectile.alo	Projectiles.xml 
p_spmat_shot.alo	Projectiles.xml 
p_hyper_gun_slug.alo	Projectiles.xml 
p_planetary_turbolaser.alo	Projectiles.xml 
p_ion_cannon00.alo	Projectiles.xml 
p_turbolaser_burst_med00_green.alo	Projectiles.xml 
p_turbolaser_burst_med00.alo	Projectiles.xml 
p_magnepulse_shot.alo	Projectiles.xml 
w_thermal_detonator.alo	Projectiles.xml 
w_thermal_detonator_empire.alo	Projectiles.xml 
w_thermal_detonator_underworld.alo	Projectiles.xml 
w_thermal_detonator_rebel.alo	Projectiles.xml 
p_seismic_bomb00.alo	Projectiles.xml 
p_disruptor_projectile.alo	Projectiles.xml 
p_kraytdestoyer_presuperblast.alo	Projectiles.xml 
p_kraytdestoyer_superblast.alo	Projectiles.xml 
p_kraytdestroyer_superblast_special.alo	Projectiles.xml 
p_blueglow2.alo	Projectiles.xml 
p_proton_vengance_small.alo	Projectiles.xml 
p_proton_vengance.alo	Projectiles.xml 
p_mz8shot.alo	Projectiles.xml 
w_landmine.alo	Projectiles.xml Projectiles_Infantry.xml 
p_urai_poison_projectile.alo	Projectiles.xml 
w_grenade.alo	Projectiles.xml Projectiles_Infantry.xml Projectiles_Land.xml 
w_carbonite_missile.alo	Projectiles.xml 
p_ui_spacestation.alo	Projectiles.xml 
p_infantry_blaster_short.alo	Projectiles_Infantry.xml 
p_infantry_blaster_long.alo	Projectiles_Infantry.xml Projectiles_Land.xml 
p_infantry_blaster_short_p.alo	Projectiles_Infantry.xml 
w_white_missile.alo	Projectiles_Infantry.xml Projectiles_Land.xml 
p_infantry_blaster_short_y.alo	Projectiles_Infantry.xml 
p_infantry_ion_disruptor.alo	Projectiles_Infantry.xml 
p_infantry_blast_cannon.alo	Projectiles_Infantry.xml 
p_land_e_web.alo	Projectiles_Infantry.xml 
w_laser_smallb.alo	Projectiles_Infantry.xml Projectiles_SM.xml 
w_laser_land_r.alo	Projectiles_Land.xml 
p_artillery_shell.alo	Projectiles_Land.xml 
p_flak.alo	Projectiles_Land.xml 
w_laser_land_g.alo	Projectiles_Land.xml 
w_land_flak_missile.alo	Projectiles_Land.xml 
w_land_missile.alo	Projectiles_Land.xml 
w_mptl_torpedo.alo	Projectiles_Land.xml 
p_land_century_blaster.alo	Projectiles_Land.xml 
w_composite_beam.alo	Projectiles_Land.xml 
p_land_at_ar.alo	Projectiles_Land.xml 
p_land_freerunner_blaster.alo	Projectiles_Land.xml 
w_single_turbolaser_r.alo	Projectiles_SM.xml 
w_dual_turbolaser_r.alo	Projectiles_SM.xml 
w_quad_turbolaser_r.alo	Projectiles_SM.xml 
w_single_turbolaser_b.alo	Projectiles_SM.xml 
w_dual_turbolaser_b.alo	Projectiles_SM.xml 
w_quad_turbolaser_b.alo	Projectiles_SM.xml 
w_single_turbolaser_g.alo	Projectiles_SM.xml 
w_dual_turbolaser_g.alo	Projectiles_SM.xml 
w_quad_turbolaser_g.alo	Projectiles_SM.xml 
w_octuple_turbolaser_g.alo	Projectiles_SM.xml 
w_single_ion_cannon.alo	Projectiles_SM.xml 
w_dual_ion_cannon.alo	Projectiles_SM.xml 
w_fighter_ion_cannon.alo	Projectiles_SM.xml 
w_protontorp.alo	Projectiles_SM.xml 
w_plasmatorp.alo	Projectiles_SM.xml 
w_magpulsetorp.alo	Projectiles_SM.xml 
w_concussion_missile2.alo	Projectiles_SM.xml 
w_concussion_missile3.alo	Projectiles_SM.xml 
w_heavy_missile.alo	Projectiles_SM.xml 
w_diamd_missile.alo	Projectiles_SM.xml 
w_leveler_missile.alo	Projectiles_SM.xml 
p_salvation_fac.alo	Projectiles_SM.xml 
cor1.alo	PROPS_CORELLIA.xml 
cor2.alo	PROPS_CORELLIA.xml 
cor3.alo	PROPS_CORELLIA.xml 
cor4.alo	PROPS_CORELLIA.xml 
cor5.alo	PROPS_CORELLIA.xml 
cor6.alo	PROPS_CORELLIA.xml 
cor7.alo	PROPS_CORELLIA.xml 
cor8.alo	PROPS_CORELLIA.xml 
cor9.alo	PROPS_CORELLIA.xml 
cor10.alo	PROPS_CORELLIA.xml 
train.alo	PROPS_CORELLIA.xml 
rails.alo	PROPS_CORELLIA.xml 
rails_with_support.alo	PROPS_CORELLIA.xml 
trim_station.alo	PROPS_CORELLIA.xml 
in.alo	PROPS_CORELLIA.xml 
rails_turn.alo	PROPS_CORELLIA.xml 
rails_turn_with_supports.alo	PROPS_CORELLIA.xml 
support.alo	PROPS_CORELLIA.xml 
light.alo	PROPS_CORELLIA.xml 
2.alo	PROPS_CORELLIA.xml 
shot.alo	PROPS_CORELLIA.xml 
long.alo	PROPS_CORELLIA.xml 
end.alo	PROPS_CORELLIA.xml 
turn.alo	PROPS_CORELLIA.xml 
flat.alo	PROPS_CORELLIA.xml 
sign2.alo	PROPS_CORELLIA.xml 
sign3.alo	PROPS_CORELLIA.xml 
sign4.alo	PROPS_CORELLIA.xml 
ways.alo	PROPS_CORELLIA.xml 
out.alo	PROPS_CORELLIA.xml 
inside.alo	PROPS_CORELLIA.xml 
outside.alo	PROPS_CORELLIA.xml 
1.alo	PROPS_CORELLIA.xml 
sign.alo	PROPS_CORELLIA.xml 
stack.alo	PROPS_CORELLIA.xml 
doorway.alo	PROPS_CORELLIA.xml 
s.alo	PROPS_CORELLIA.xml PROPS_DECORATIONS_AND_TRANSPORTS.xml 
m.alo	PROPS_CORELLIA.xml PROPS_DECORATIONS_AND_TRANSPORTS.xml 
corner.alo	PROPS_CORELLIA.xml 
statue.alo	PROPS_CORELLIA.xml 
transport1.alo	PROPS_DECORATIONS_AND_TRANSPORTS.xml 
transport2.alo	PROPS_DECORATIONS_AND_TRANSPORTS.xml 
transport3.alo	PROPS_DECORATIONS_AND_TRANSPORTS.xml 
transport4.alo	PROPS_DECORATIONS_AND_TRANSPORTS.xml 
transport5.alo	PROPS_DECORATIONS_AND_TRANSPORTS.xml 
transport5p.alo	PROPS_DECORATIONS_AND_TRANSPORTS.xml 
transport5r.alo	PROPS_DECORATIONS_AND_TRANSPORTS.xml 
transport5b.alo	PROPS_DECORATIONS_AND_TRANSPORTS.xml 
conteiner.alo	PROPS_DECORATIONS_AND_TRANSPORTS.xml 
conteiner2.alo	PROPS_DECORATIONS_AND_TRANSPORTS.xml 
conteiner2gr.alo	PROPS_DECORATIONS_AND_TRANSPORTS.xml 
conteiner3.alo	PROPS_DECORATIONS_AND_TRANSPORTS.xml 
conteiner3gr.alo	PROPS_DECORATIONS_AND_TRANSPORTS.xml 
conteiner4.alo	PROPS_DECORATIONS_AND_TRANSPORTS.xml 
conteiner4gr.alo	PROPS_DECORATIONS_AND_TRANSPORTS.xml 
conteiner5gr.alo	PROPS_DECORATIONS_AND_TRANSPORTS.xml 
conteiner5.alo	PROPS_DECORATIONS_AND_TRANSPORTS.xml 
barricade1.alo	PROPS_DECORATIONS_AND_TRANSPORTS.xml 
barricade2.alo	PROPS_DECORATIONS_AND_TRANSPORTS.xml 
barricade3.alo	PROPS_DECORATIONS_AND_TRANSPORTS.xml 
barricade4.alo	PROPS_DECORATIONS_AND_TRANSPORTS.xml 
bacta.alo	PROPS_DECORATIONS_AND_TRANSPORTS.xml 
b.alo	PROPS_DECORATIONS_AND_TRANSPORTS.xml 
bed.alo	PROPS_DECORATIONS_AND_TRANSPORTS.xml 
bed1.alo	PROPS_DECORATIONS_AND_TRANSPORTS.xml 
bed2.alo	PROPS_DECORATIONS_AND_TRANSPORTS.xml 
turret.alo	PROPS_DECORATIONS_AND_TRANSPORTS.xml PROPS_IMPIREAL.xml 
kiosk.alo	PROPS_DRO_KAAS.xml 
bench.alo	PROPS_DRO_KAAS.xml 
computer.alo	PROPS_IMPIREAL.xml 
crawler.alo	PROPS_IMPIREAL.xml 
aa-turret.alo	PROPS_IMPIREAL.xml 
w_junk_1.alo	Props_junk.xml 
w_junk_2.alo	Props_junk.xml 
w_junk_3.alo	Props_junk.xml 
w_junk_3_b.alo	Props_junk.xml 
w_junk_4.alo	Props_junk.xml 
w_junk_5.alo	Props_junk.xml 
w_junk_6.alo	Props_junk.xml 
w_junk_6_b.alo	Props_junk.xml 
w_junk_7.alo	Props_junk.xml 
w_junk_8.alo	Props_junk.xml 
w_junk_9.alo	Props_junk.xml 
w_junk_crawler.alo	Props_junk.xml 
w_junk_nozzle.alo	Props_junk.xml 
w_junk_starship_engine.alo	Props_junk.xml 
w_junk_nose.alo	Props_junk.xml 
w_junk_ship_girder.alo	Props_junk.xml 
w_junk_treads.alo	Props_junk.xml 
hammerhead_crashed.alo	Props_junk.xml 
nv_gozanti_wreck.alo	Props_junk.xml 
nv_consular_wreck.alo	Props_junk.xml 
prop_mygeeto1.alo	Props_MYGEETO.xml 
prop_mygeeto2.alo	Props_MYGEETO.xml 
prop_mygeeto3.alo	Props_MYGEETO.xml 
w_mygeeto_building_a.alo	Props_MYGEETO.xml 
w_mygeeto_building_b.alo	Props_MYGEETO.xml 
w_mygeeto_building_c.alo	Props_MYGEETO.xml 
w_mygeeto_building_d.alo	Props_MYGEETO.xml 
w_mygeeto_building_e.alo	Props_MYGEETO.xml 
w_mygeeto_corner_a.alo	Props_MYGEETO.xml 
w_mygeeto_corner_b.alo	Props_MYGEETO.xml 
w_mygeeto_lamp_a.alo	Props_MYGEETO.xml 
w_mygeeto_wall_a.alo	Props_MYGEETO.xml 
w_mygeeto_wall_b.alo	Props_MYGEETO.xml 
w_mygeeto_wall_c.alo	Props_MYGEETO.xml 
w_mygeeto_wall_d.alo	Props_MYGEETO.xml 
w_tie_assembly_line_07.alo	Props_new_order.xml 
w_tie_assembly_line_00.alo	Props_new_order.xml 
w_tie_assembly_line_01.alo	Props_new_order.xml 
w_tie_ln_panels_8.alo	Props_new_order.xml 
w_tie_cockpit.alo	Props_new_order.xml 
w_tie_in_panels_8.alo	Props_new_order.xml 
w_grndcvr_rudrig_00.alo	Props_new_order.xml 
w_bush_rudrig_00.alo	Props_new_order.xml 
w_rudrig_sinkhole.alo	Props_new_order.xml 
w_aat_debris.alo	Props_new_order.xml 
w_hardcell_debris.alo	Props_new_order.xml 
nom_misc_hutt_banner_01.alo	Props_new_order.xml 
nom_misc_hutt_banner_02.alo	Props_new_order.xml 
nom_misc_hutt_banner_03.alo	Props_new_order.xml 
nom_misc_hutt_banner_04.alo	Props_new_order.xml 
nom_misc_imperial_banner_01.alo	Props_new_order.xml 
nom_misc_imperial_banner_02.alo	Props_new_order.xml 
nom_misc_imperial_banner_03.alo	Props_new_order.xml 
nom_misc_imperial_banner_04.alo	Props_new_order.xml 
w_druckenwell_house.alo	Props_new_order.xml 
w_druckenwell_platform.alo	Props_new_order.xml 
w_druckenwell_small_obelisk.alo	Props_new_order.xml 
w_druckenwell_big_obelisk.alo	Props_new_order.xml 
ev_tiefighter.alo	Props_story.xml Spaceunitsfighters.xml Squadrons.xml Units_hero_empire_181st.xml Units_sls_empire.xml 
w_star_destroyer_construction.alo	Props_story.xml Spaceprops.xml 
w_star_destroyer_construction_d.alo	Props_story.xml 
ev_lambdashuttle_space.alo	Props_story.xml Transportunits.xml 
eb_construction_pod.alo	Props_story.xml Spaceprops.xml 
w_orbital_resource_container.alo	Props_story.xml 
w_orbital_resource_container_small.alo	Props_story.xml 
eb_dock00.alo	Props_story.xml Spaceprops.xml 
eb_dock_break.alo	Props_story.xml 
w_crates11.alo	Props_story.xml PROPS_YODEN_GENERIC.xml 
w_at-at_construction.alo	Props_story.xml PROPS_YODEN_STORY.xml 
w_spice_crate.alo	Props_story.xml PROPS_YODEN_STORY.xml 
ui_tyber_in_jail.alo	Props_story.xml PROPS_YODEN_STORY.xml 
ni_gmale_urbanprison_a.alo	Props_story.xml 
ni_gmale_urbanprison_b.alo	Props_story.xml 
ni_gmale_urbanprison_c.alo	Props_story.xml 
ni_gmale_urbanprison_d.alo	Props_story.xml 
ni_gmale_urbanprison_e.alo	Props_story.xml 
ni_piratesoldierprison.alo	Props_story.xml 
rv_mfalcon_land.alo	Props_story.xml PROPS_YODEN_STORY.xml Units_hero_rebel_han_solo.xml 
eb_cin_basewall-mid.alo	Props_story.xml PROPS_YODEN_STORY.xml 
w_crates08.alo	Props_story.xml PROPS_YODEN_GENERIC.xml 
nv_lds.alo	Props_story.xml Spacebuildablesskirmish.xml Specialstructures.xml 
eb_cin_basewall-thresh.alo	Props_story.xml 
w_prison_terminal.alo	Props_story.xml PROPS_YODEN_STORY.xml 
ni_ewok_c.alo	Props_story.xml 
ni_ewok_b.alo	Props_story.xml 
eb_officeracademy.alo	Props_story.xml PROPS_YODEN_URBAN.xml 
ev_at-barge.alo	Props_story.xml Transportunits.xml 
cin_bridge.alo	Props_story.xml 
cin_deathstar_high.alo	Props_story.xml 
w_planet_deathstar02_ii.alo	Props_story.xml PROPS_YODEN_STORY.xml 
ev_at-at.alo	Props_story.xml Units_land_empire_AT-AT.xml 
ev_at-st.alo	Props_story.xml Units_land_empire_AT-ST.xml 
ev_at-aa.alo	Props_story.xml 
ev_2mtank.alo	Props_story.xml 
ev_tiecrawler.alo	Props_story.xml Units_land_empire_TIE_Mauler.xml 
w_kraytdragonskull.alo	Props_story.xml PROPS_YODEN_DESERT.xml 
w_kraytdragonribs.alo	Props_story.xml PROPS_YODEN_DESERT.xml 
w_kraytdragontail.alo	Props_story.xml PROPS_YODEN_DESERT.xml 
ai_rancor.alo	Props_story.xml PROPS_YODEN_STORY.xml 
w_urbanblock_a.alo	Props_story.xml PROPS_YODEN_URBAN.xml 
w_planet_moon_high.alo	Props_story.xml PROPS_YODEN_STORY.xml Spaceprops.xml 
w_planet_desert-urban_high.alo	Props_story.xml PROPS_YODEN_STORY.xml Spaceprops.xml 
w_planet_swamp00.alo	Props_story.xml PROPS_YODEN_STORY.xml Spaceprops.xml 
rv_z-95.alo	Props_story.xml 
nb_sandpeople_tent.alo	Props_story.xml PROPS_YODEN_DESERT.xml 
ni_sandpeople_b.alo	Props_story.xml 
ni_jawa.alo	Props_story.xml 
nb_dch.alo	Props_story.xml PROPS_YODEN_DESERT.xml 
nb_dch_b.alo	Props_story.xml PROPS_YODEN_DESERT.xml 
nb_dch_c.alo	Props_story.xml PROPS_YODEN_DESERT.xml 
ni_gmale_desert_a.alo	Props_story.xml 
w_tree_gnarl_00_hi.alo	Props_story.xml PROPS_YODEN_SWAMP.xml 
ai_dianoga.alo	Props_story.xml PROPS_YODEN_SWAMP.xml 
w_icemntrnge01.alo	Props_story.xml PROPS_YODEN_SNOW.xml 
wc_bantha.alo	Props_story.xml 
ai_tauntaun.alo	Props_story.xml 
ai_wampa.alo	Props_story.xml 
ai_wampacave.alo	Props_story.xml PROPS_YODEN_SNOW.xml PROPS_YODEN_STORY.xml 
ai_groundbeetle.alo	Props_story.xml 
w_felucia_plant_06.alo	Props_story.xml 
w_felucia_plant_01.alo	Props_story.xml 
w_felucia_plant_00_tall.alo	Props_story.xml 
w_tree_dec_canopy_a.alo	Props_story.xml PROPS_YODEN_TEMPERATE.xml 
w_tempmntrnge00.alo	Props_story.xml 
w_bird_light.alo	Props_story.xml 
ai_shaaks.alo	Props_story.xml 
w_gunganhead.alo	Props_story.xml PROPS_YODEN_GENERIC.xml 
w_theedbuild_b.alo	Props_story.xml PROPS_YODEN_TEMPERATE.xml 
w_theedbuild_c.alo	Props_story.xml PROPS_YODEN_TEMPERATE.xml 
nb_rancor_cave.alo	Props_story.xml 
ai_sarlacc.alo	Props_story.xml 
ai_womprat.alo	Props_story.xml 
w_sithtomb.alo	Props_story.xml PROPS_YODEN_TEMPERATE.xml 
w_sithstatue.alo	Props_story.xml PROPS_YODEN_TEMPERATE.xml 
nb_wookiee_tree.alo	Props_story.xml PROPS_YODEN_FOREST.xml 
ri_wookiee01.alo	Props_story.xml 
w_black_box.alo	Props_story.xml 
w_theedwall_a.alo	Props_story.xml PROPS_YODEN_TEMPERATE.xml 
w_theedwall_b.alo	Props_story.xml PROPS_YODEN_TEMPERATE.xml 
w_theedwall_c.alo	Props_story.xml PROPS_YODEN_TEMPERATE.xml 
w_observation_tower.alo	Props_story.xml PROPS_YODEN_GENERIC.xml PROPS_YODEN_STORY.xml 
w_sithartifact_pedestal.alo	Props_story.xml PROPS_YODEN_GENERIC.xml PROPS_YODEN_STORY.xml 
w_urbancorner_a.alo	Props_story.xml PROPS_YODEN_STORY.xml PROPS_YODEN_URBAN.xml 
w_prop_darktrooper_one.alo	Props_story.xml 
w_prop_darktrooper_two.alo	Props_story.xml 
w_prop_darktroop_three.alo	Props_story.xml 
w_bountyhunter.alo	Props_story.xml PROPS_YODEN_STORY.xml 
w_alarm_light.alo	Props_story.xml PROPS_YODEN_STORY.xml 
eb_basewall-mid.alo	Props_story.xml PROPS_YODEN_GENERIC.xml PROPS_YODEN_URBAN.xml 
ni_darksideadepts.alo	Props_story.xml 
w_prison_bars.alo	Props_story.xml PROPS_YODEN_STORY.xml 
eb_guardtower.alo	Props_story.xml PROPS_YODEN_STORY.xml 
nb_cage.alo	Props_story.xml PROPS_YODEN_GENERIC.xml 
w_dathbridge.alo	Props_story.xml PROPS_YODEN_STORY.xml 
w_cloud_car.alo	Props_story.xml 
w_bespin_refinery.alo	Props_story.xml PROPS_YODEN_STORY.xml 
w_prop_deadmen_a.alo	Props_story.xml PROPS_YODEN_STORY.xml 
w_prop_deadat-st_a.alo	Props_story.xml PROPS_YODEN_STORY.xml 
w_prop_deadat-st_b.alo	Props_story.xml PROPS_YODEN_STORY.xml 
w_droidconvey_a.alo	Props_story.xml PROPS_YODEN_STORY.xml 
w_propdeadst.alo	Props_story.xml 
ni_twilek_f_nogun.alo	Props_story.xml 
ni_gmale_urban_c_nogun.alo	Props_story.xml 
ni_moncalciv_nogun.alo	Props_story.xml 
ni_sullustan_nogun.alo	Props_story.xml 
ev_executorstardestroyer.alo	Props_story.xml 
eb_station_05.alo	Props_story.xml Starbases.xml 
i_eb_station_level5.alo	Props_story.xml Starbases.xml 
uv_rz-52boardingship.alo	Props_story.xml 
w_jail_bed.alo	Props_story.xml 
w_jail_bed_tyber.alo	Props_story.xml PROPS_YODEN_STORY.xml 
w_urai_hologram.alo	Props_story.xml PROPS_YODEN_STORY.xml 
w_jaba.alo	Props_story.xml PROPS_YODEN_STORY.xml 
w_mousedroid_solo.alo	Props_story.xml 
w_sithartifact.alo	Props_story.xml PROPS_YODEN_STORY.xml 
w_shaakskull.alo	Props_story.xml 
nb_bothan_building.alo	Props_story.xml PROPS_YODEN_URBAN.xml 
w_urbanhalfwall_side.alo	Props_story.xml 
w_prop_pwrbox.alo	Props_story.xml 
w_prop_moistcollect.alo	PROPS_YODEN_DESERT.xml 
w_tat_rockform00.alo	PROPS_YODEN_DESERT.xml 
w_tat_rockform01.alo	PROPS_YODEN_DESERT.xml 
w_tat_rockform02.alo	PROPS_YODEN_DESERT.xml 
w_geonosis_rockform00.alo	PROPS_YODEN_DESERT.xml 
w_geo_rockform01.alo	PROPS_YODEN_DESERT.xml 
w_asteroid01.alo	PROPS_YODEN_DESERT.xml Spaceprops.xml Specialstructures.xml 
w_utapau_hole.alo	PROPS_YODEN_DESERT.xml 
nv_sand_crawler.alo	PROPS_YODEN_DESERT.xml 
w_hutt_spawnbuilding.alo	PROPS_YODEN_DESERT.xml 
w_huttpalace_variant.alo	PROPS_YODEN_DESERT.xml 
w_tatooine_building01.alo	PROPS_YODEN_DESERT.xml 
w_tatooine_building02.alo	PROPS_YODEN_DESERT.xml 
w_tatooine_building03.alo	PROPS_YODEN_DESERT.xml 
nb_idh.alo	PROPS_YODEN_DESERT.xml 
w_endrrockclstr00.alo	PROPS_YODEN_FOREST.xml 
w_endrrockclstr01.alo	PROPS_YODEN_FOREST.xml 
w_endrrockclstr02.alo	PROPS_YODEN_FOREST.xml 
w_endrrockclstr03.alo	PROPS_YODEN_FOREST.xml 
w_endrrckslide00.alo	PROPS_YODEN_FOREST.xml 
w_treepine_stmp00.alo	PROPS_YODEN_FOREST.xml 
w_treeredwood_stmp00.alo	PROPS_YODEN_FOREST.xml 
w_tree_ever_00_hi.alo	PROPS_YODEN_FOREST.xml 
w_tree_ever_canopy_a.alo	PROPS_YODEN_FOREST.xml 
w_tree_ever_canopy_b.alo	PROPS_YODEN_FOREST.xml 
w_tree_ever_00_cluster.alo	PROPS_YODEN_FOREST.xml 
nb_wookiee_tree_plain.alo	PROPS_YODEN_FOREST.xml 
w_tree_ever_01_hi.alo	PROPS_YODEN_FOREST.xml 
w_tree_ever_01_cluster.alo	PROPS_YODEN_FOREST.xml 
w_treepine01.alo	PROPS_YODEN_FOREST.xml 
w_tree_dec_01_hi.alo	PROPS_YODEN_FOREST.xml PROPS_YODEN_TEMPERATE.xml 
w_grndcvr_e.alo	PROPS_YODEN_FOREST.xml 
w_grndcvr_f.alo	PROPS_YODEN_FOREST.xml 
w_grndcvr_g.alo	PROPS_YODEN_FOREST.xml 
w_grndcvr_h.alo	PROPS_YODEN_FOREST.xml 
w_grndcvr_i.alo	PROPS_YODEN_FOREST.xml 
nb_ewok_tree.alo	PROPS_YODEN_FOREST.xml 
w_explosive_crate.alo	PROPS_YODEN_GENERIC.xml 
rv_snowspeeder_dmg.alo	PROPS_YODEN_GENERIC.xml 
w_crates01.alo	PROPS_YODEN_GENERIC.xml 
w_crates02.alo	PROPS_YODEN_GENERIC.xml 
w_crates03.alo	PROPS_YODEN_GENERIC.xml 
w_crates04.alo	PROPS_YODEN_GENERIC.xml 
w_crates05.alo	PROPS_YODEN_GENERIC.xml 
w_crates06.alo	PROPS_YODEN_GENERIC.xml 
w_crates07.alo	PROPS_YODEN_GENERIC.xml 
w_crates09.alo	PROPS_YODEN_GENERIC.xml 
w_crates10.alo	PROPS_YODEN_GENERIC.xml 
w_crates12.alo	PROPS_YODEN_GENERIC.xml 
w_crates13.alo	PROPS_YODEN_GENERIC.xml 
w_crates14.alo	PROPS_YODEN_GENERIC.xml 
w_crates15.alo	PROPS_YODEN_GENERIC.xml 
w_crates16.alo	PROPS_YODEN_GENERIC.xml 
w_crates17.alo	PROPS_YODEN_GENERIC.xml 
w_crates18.alo	PROPS_YODEN_GENERIC.xml 
w_crates19.alo	PROPS_YODEN_GENERIC.xml 
w_crates20.alo	PROPS_YODEN_GENERIC.xml 
w_crates21.alo	PROPS_YODEN_GENERIC.xml 
w_crates22.alo	PROPS_YODEN_GENERIC.xml 
w_crates23.alo	PROPS_YODEN_GENERIC.xml 
w_crates24.alo	PROPS_YODEN_GENERIC.xml 
w_crates25.alo	PROPS_YODEN_GENERIC.xml 
w_crates26.alo	PROPS_YODEN_GENERIC.xml 
w_crates27.alo	PROPS_YODEN_GENERIC.xml 
w_crates28.alo	PROPS_YODEN_GENERIC.xml 
w_crates29.alo	PROPS_YODEN_GENERIC.xml 
w_fuel_pipe00.alo	PROPS_YODEN_GENERIC.xml 
w_fuel_pipe01.alo	PROPS_YODEN_GENERIC.xml 
w_fuel_pipe02.alo	PROPS_YODEN_GENERIC.xml 
w_fuel_cell_1.alo	PROPS_YODEN_GENERIC.xml 
w_fuel_cell_2.alo	PROPS_YODEN_GENERIC.xml 
w_fuel_cell_3.alo	PROPS_YODEN_GENERIC.xml 
w_massassi_temple.alo	PROPS_YODEN_GENERIC.xml 
i_facing_arrow.alo	PROPS_YODEN_GENERIC.xml Spaceprops.xml 
ev_crashed_tyderium.alo	PROPS_YODEN_GENERIC.xml 
w_goodground_bags.alo	PROPS_YODEN_GENERIC.xml 
ev_acclamator.alo	PROPS_YODEN_GENERIC.xml 
ev_acclamator_wreck_a.alo	PROPS_YODEN_GENERIC.xml 
nv_jedicruiser.alo	PROPS_YODEN_GENERIC.xml Uniqueunits.xml 
uv_kraytclassdestroyer_cine.alo	PROPS_YODEN_GENERIC.xml Spaceunitssupers.xml 
uv_interceptoriv_cine.alo	PROPS_YODEN_GENERIC.xml 
w_planet_endor_high.alo	PROPS_YODEN_GENERIC.xml Spaceprops.xml 
w_space_girder00.alo	PROPS_YODEN_GENERIC.xml Spaceprops.xml 
test_wall.alo	PROPS_YODEN_GENERIC.xml 
w_alphagirder.alo	PROPS_YODEN_GENERIC.xml 
w_rockclstr00.alo	PROPS_YODEN_SNOW.xml 
w_rockclstr01.alo	PROPS_YODEN_SNOW.xml 
w_crystals_illum.alo	PROPS_YODEN_SNOW.xml 
w_icerckslide00.alo	PROPS_YODEN_SNOW.xml 
w_tree_ever_snow01_hi.alo	PROPS_YODEN_SNOW.xml 
w_tree_ever_snow01_cluster.alo	PROPS_YODEN_SNOW.xml 
w_tree_ever_snow02_hi.alo	PROPS_YODEN_SNOW.xml 
w_tree_ever_snow02_cluster.alo	PROPS_YODEN_SNOW.xml 
w_icemntrnge00.alo	PROPS_YODEN_SNOW.xml 
w_hothdoors.alo	PROPS_YODEN_SNOW.xml 
w_hothdoorsgreg.alo	PROPS_YODEN_SNOW.xml 
nb_ich.alo	PROPS_YODEN_SNOW.xml 
nb_sch.alo	PROPS_YODEN_SNOW.xml 
w_prop_deadbothan.alo	PROPS_YODEN_STORY.xml 
w_swampvine00.alo	PROPS_YODEN_SWAMP.xml 
w_swampvine01.alo	PROPS_YODEN_SWAMP.xml 
w_fern03.alo	PROPS_YODEN_SWAMP.xml 
w_swampgrass00.alo	PROPS_YODEN_SWAMP.xml 
w_fern02.alo	PROPS_YODEN_SWAMP.xml 
w_tree_swmp_00_hi.alo	PROPS_YODEN_SWAMP.xml 
w_tree_swmp_00_cluster.alo	PROPS_YODEN_SWAMP.xml 
w_tree_bamboo_00_cluster.alo	PROPS_YODEN_SWAMP.xml 
w_treeswampcard00.alo	PROPS_YODEN_SWAMP.xml 
w_swampgrass01.alo	PROPS_YODEN_TEMPERATE.xml 
w_bush_cypress.alo	PROPS_YODEN_TEMPERATE.xml 
w_temp_cattail.alo	PROPS_YODEN_TEMPERATE.xml 
w_tree_dec_00_hi.alo	PROPS_YODEN_TEMPERATE.xml 
w_tree_dec_00_cluster.alo	PROPS_YODEN_TEMPERATE.xml 
w_tree_dec_01_cluster.alo	PROPS_YODEN_TEMPERATE.xml 
w_tree_dec_00yellow_cluster.alo	PROPS_YODEN_TEMPERATE.xml 
w_tree_dec_01red_hi.alo	PROPS_YODEN_TEMPERATE.xml 
w_tree_dec_01red_cluster.alo	PROPS_YODEN_TEMPERATE.xml 
w_treepalm_a.alo	PROPS_YODEN_TEMPERATE.xml 
w_treepalm_a_cluster.alo	PROPS_YODEN_TEMPERATE.xml 
w_tree_alien_00_hi.alo	PROPS_YODEN_TEMPERATE.xml 
w_tree_alien_00_cluster.alo	PROPS_YODEN_TEMPERATE.xml 
w_grndcvr_a.alo	PROPS_YODEN_TEMPERATE.xml 
w_grndcvr_b.alo	PROPS_YODEN_TEMPERATE.xml 
w_grndcvr_c.alo	PROPS_YODEN_TEMPERATE.xml 
w_grndcvr_d.alo	PROPS_YODEN_TEMPERATE.xml 
w_grndcvr_felucia.alo	PROPS_YODEN_TEMPERATE.xml 
w_ruins00.alo	PROPS_YODEN_TEMPERATE.xml 
w_ruins01.alo	PROPS_YODEN_TEMPERATE.xml 
w_ruins02.alo	PROPS_YODEN_TEMPERATE.xml 
w_ruins03.alo	PROPS_YODEN_TEMPERATE.xml 
w_theedbuild_a.alo	PROPS_YODEN_TEMPERATE.xml 
w_theedpalace.alo	PROPS_YODEN_TEMPERATE.xml 
w_waterfallspray_top.alo	PROPS_YODEN_TEMPERATE.xml 
w_planet_alderaan_high.alo	PROPS_YODEN_TEMPERATE.xml Spaceprops.xml 
w_felucia_rock_arch00.alo	PROPS_YODEN_TEMPERATE.xml 
w_paddlewheel.alo	PROPS_YODEN_TEMPERATE.xml 
nb_grandarena.alo	PROPS_YODEN_URBAN.xml Specialstructures.xml 
alttest.alo	PROPS_YODEN_URBAN.xml 
w_r2_terminal.alo	PROPS_YODEN_URBAN.xml 
eb_checkpointstructure.alo	PROPS_YODEN_URBAN.xml 
w_uplink_station_abandon.alo	PROPS_YODEN_URBAN.xml 
eb_icc_landingpad.alo	PROPS_YODEN_URBAN.xml 
nb_sullest_cave.alo	PROPS_YODEN_URBAN.xml 
nb_comm_jamm.alo	PROPS_YODEN_URBAN.xml 
nb_prison.alo	PROPS_YODEN_URBAN.xml Secondarystructures.xml Specialstructures.xml 
w_carpet_cap.alo	PROPS_YODEN_URBAN.xml 
w_urbanblock_a_mission11.alo	PROPS_YODEN_URBAN.xml 
w_urbanblock_b.alo	PROPS_YODEN_URBAN.xml 
w_urbanhalfwall_a.alo	PROPS_YODEN_URBAN.xml 
w_urbanhalfwall_b.alo	PROPS_YODEN_URBAN.xml 
w_urbanhalfwall_c.alo	PROPS_YODEN_URBAN.xml 
w_urbantraintunnel2.alo	PROPS_YODEN_URBAN.xml 
w_prisonwall.alo	PROPS_YODEN_URBAN.xml 
w_girder_big.alo	PROPS_YODEN_URBAN.xml 
w_urbansquare_a.alo	PROPS_YODEN_URBAN.xml 
w_urbanpalpstatue.alo	PROPS_YODEN_URBAN.xml 
w_urbanobistatue.alo	PROPS_YODEN_URBAN.xml 
w_urbanoddstatue.alo	PROPS_YODEN_URBAN.xml 
w_urbansquare_b.alo	PROPS_YODEN_URBAN.xml 
w_urbansquare_c.alo	PROPS_YODEN_URBAN.xml 
w_urbansquare_d.alo	PROPS_YODEN_URBAN.xml 
w_urbanwalk_a.alo	PROPS_YODEN_URBAN.xml 
w_urbanstreetlite.alo	PROPS_YODEN_URBAN.xml 
w_urbanwall_a.alo	PROPS_YODEN_URBAN.xml 
w_urbanwall_b.alo	PROPS_YODEN_URBAN.xml 
w_urban_builds_generic00.alo	PROPS_YODEN_URBAN.xml 
w_urban_builds_generic01.alo	PROPS_YODEN_URBAN.xml 
w_urban_builds_generic02.alo	PROPS_YODEN_URBAN.xml 
w_urban_builds_generic03.alo	PROPS_YODEN_URBAN.xml 
w_alderaanbuilding_a.alo	PROPS_YODEN_URBAN.xml 
w_alderaanbuilding_b.alo	PROPS_YODEN_URBAN.xml 
w_alderaanbuilding_c.alo	PROPS_YODEN_URBAN.xml 
w_alderaanbuilding_d.alo	PROPS_YODEN_URBAN.xml 
w_alderaanbuilding_e.alo	PROPS_YODEN_URBAN.xml 
w_urbantraintunnel.alo	PROPS_YODEN_URBAN.xml 
w_urbantraintunnel2_long.alo	PROPS_YODEN_URBAN.xml 
w_urban_corbuild_a.alo	PROPS_YODEN_URBAN.xml 
w_urban_corbuild_b.alo	PROPS_YODEN_URBAN.xml 
w_urban_corbuild_c.alo	PROPS_YODEN_URBAN.xml 
w_urban_corbuild_d.alo	PROPS_YODEN_URBAN.xml 
w_urban_corbuild_e.alo	PROPS_YODEN_URBAN.xml 
w_urban_corbuild_f.alo	PROPS_YODEN_URBAN.xml 
w_jeditemple.alo	PROPS_YODEN_URBAN.xml 
w_urban_tarisbuild_a.alo	PROPS_YODEN_URBAN.xml 
w_urban_tarisbuild_b.alo	PROPS_YODEN_URBAN.xml 
w_urbanrailing.alo	PROPS_YODEN_URBAN.xml 
w_kamino_edgewall.alo	PROPS_YODEN_URBAN.xml 
w_kaminobuilding00.alo	PROPS_YODEN_URBAN.xml 
w_kamino_tower_lrg.alo	PROPS_YODEN_URBAN.xml 
w_kamino_tower_sml.alo	PROPS_YODEN_URBAN.xml 
w_bespin_building01.alo	PROPS_YODEN_URBAN.xml 
w_bespin_building02.alo	PROPS_YODEN_URBAN.xml 
w_bespin_building03.alo	PROPS_YODEN_URBAN.xml 
w_bespin_fan.alo	PROPS_YODEN_URBAN.xml 
w_gas_collector.alo	PROPS_YODEN_URBAN.xml 
nb_gunga_building.alo	PROPS_YODEN_URBAN.xml 
nb_moncal_building.alo	PROPS_YODEN_URBAN.xml 
nb_twilek_building.alo	PROPS_YODEN_URBAN.xml 
w_imperialpalace.alo	PROPS_YODEN_URBAN.xml 
nb_mustmushroom.alo	PROPS_YODEN_URBAN.xml 
nb_mandalorian_barracks.alo	PROPS_YODEN_URBAN.xml 
nb_nightsis_hut.alo	PROPS_YODEN_URBAN.xml 
nb_mercenaryoutfitter.alo	PROPS_YODEN_URBAN.xml Secondarystructures.xml 
nb_shuttershieldgen.alo	PROPS_YODEN_URBAN.xml Secondarystructures.xml Specialstructures.xml 
rb_ioncannon.alo	PROPS_YODEN_URBAN.xml Specialstructures.xml 
mov_em6_prison_wookies.alo	PROPS_YODEN_URBAN.xml 
eb_basewall-crn.alo	PROPS_YODEN_URBAN.xml 
eb_basewall-inside-crn.alo	PROPS_YODEN_URBAN.xml 
w_volcano_rock00.alo	PROPS_YODEN_VOLCANIC.xml 
w_volcano_rock01.alo	PROPS_YODEN_VOLCANIC.xml 
w_volcano_rock02.alo	PROPS_YODEN_VOLCANIC.xml 
w_crystals_sullust.alo	PROPS_YODEN_VOLCANIC.xml 
w_lavarockclstr00.alo	PROPS_YODEN_VOLCANIC.xml 
w_lavarockclstr01.alo	PROPS_YODEN_VOLCANIC.xml 
w_lavarockclstr02.alo	PROPS_YODEN_VOLCANIC.xml 
w_lavarockclstr03.alo	PROPS_YODEN_VOLCANIC.xml 
nb_vch.alo	PROPS_YODEN_VOLCANIC.xml 
w_geonosis_tower02.alo	PROPS_YODEN_VOLCANIC.xml 
w_geonosis_tower03.alo	PROPS_YODEN_VOLCANIC.xml 
w_geo_rockcrack01.alo	PROPS_YODEN_VOLCANIC.xml 
w_geonosis_rockform01.alo	PROPS_YODEN_VOLCANIC.xml 
i_minimap_default_click.alo	Radarmap.xml 
i_minimap_attack_move_click.alo	Radarmap.xml 
i_minimap_death_target.alo	Radarmap.xml 
i_minimap_control_point.alo	Radarmap.xml 
i_minimap_beacon.alo	Radarmap.xml 
rb_barracks_small.alo	Secondarystructures.xml 
nb_abandon_mining.alo	Secondarystructures.xml 
nb_piratebase_sml.alo	Secondarystructures.xml 
nb_commjamstation.alo	Secondarystructures.xml Specialstructures.xml 
nb_commjamstation_d.alo	Secondarystructures.xml Specialstructures.xml 
nb_spacesensornode.alo	Secondarystructures.xml Specialstructures.xml 
nb_apbase_d.alo	Secondarystructures.xml Starbases.xml 
nv_lds_pad.alo	Spacebuildablesskirmish.xml 
nv_lds_build.alo	Spacebuildablesskirmish.xml 
nv_mds_build.alo	Spacebuildablesskirmish.xml 
nv_mds.alo	Spacebuildablesskirmish.xml Specialstructures.xml 
nv_lrs_build.alo	Spacebuildablesskirmish.xml 
ev_satallite_tb.alo	Spacebuildablesskirmish.xml 
rv_satallite_repair.alo	Spacebuildablesskirmish.xml 
nv_space_build_center.alo	Spacebuildablesskirmish.xml 
nb_asteroidmining_pad.alo	Spacebuildablesskirmish.xml 
nb_asteroidmining.alo	Spacebuildablesskirmish.xml 
nb_asteroidmining_full.alo	Spacebuildablesskirmish.xml 
w_stars_low.alo	SpacePrimarySkydomes.xml 
w_stars_low1.alo	SpacePrimarySkydomes.xml 
w_stars_nebula_tt.alo	SpacePrimarySkydomes.xml 
w_stars_medium.alo	SpacePrimarySkydomes.xml 
w_stars_medium1.alo	SpacePrimarySkydomes.xml 
w_stars_high.alo	SpacePrimarySkydomes.xml 
w_stars_high1.alo	SpacePrimarySkydomes.xml 
w_stars_maw.alo	SpacePrimarySkydomes.xml 
w_stars_cine.alo	SpacePrimarySkydomes.xml 
w_stars_cine_lua.alo	SpacePrimarySkydomes.xml 
w_planet_dsii.alo	Spaceprops.xml 
w_planet_endor_giant.alo	Spaceprops.xml 
w_planet_endor_moon.alo	Spaceprops.xml 
w_planet_omman.alo	Spaceprops.xml 
w_planet_balmorra_high.alo	Spaceprops.xml 
w_planet_bonadan_high.alo	Spaceprops.xml 
w_planet_desert00.alo	Spaceprops.xml 
w_planet_urban00.alo	Spaceprops.xml 
w_planet_dagobah_high.alo	Spaceprops.xml 
w_planet_eriadu_high.alo	Spaceprops.xml 
w_planet_forest00.alo	Spaceprops.xml 
w_planet_gas00.alo	Spaceprops.xml 
w_planet_gas_silver.alo	Spaceprops.xml 
w_planet_geonosis_high.alo	Spaceprops.xml 
w_planet_hoth_high.alo	Spaceprops.xml 
w_planet_ice00.alo	Spaceprops.xml 
w_planet_kamino_high.alo	Spaceprops.xml 
w_planet_kessel_high.alo	Spaceprops.xml 
w_planet_kuat_high.alo	Spaceprops.xml 
w_planet_naboo_high.alo	Spaceprops.xml 
w_planet_ocean00.alo	Spaceprops.xml 
w_planet_ryloth_high.alo	Spaceprops.xml 
w_planet_ralltiir_high.alo	Spaceprops.xml 
w_planet_tatooine_high.alo	Spaceprops.xml 
w_planet_temperate00.alo	Spaceprops.xml 
w_planet_alderaan-urban_high.alo	Spaceprops.xml 
w_planet_volcanic.alo	Spaceprops.xml 
w_planet_wayland_high.alo	Spaceprops.xml 
w_planet_yaviniv_high.alo	Spaceprops.xml 
w_planet_mustafar_high.alo	Spaceprops.xml 
w_planet_utapau_high.alo	Spaceprops.xml 
w_asteroid_mass_huge.alo	Spaceprops.xml 
w_asteroid_mass_huge_particle.alo	Spaceprops.xml 
w_asteroid02.alo	Spaceprops.xml Specialstructures.xml 
w_asteroid00.alo	Spaceprops.xml Specialstructures.xml 
w_asteroid03.alo	Spaceprops.xml Specialstructures.xml 
eb_deathstar_trench_a.alo	Spaceprops.xml 
eb_deathstar_flat_a.alo	Spaceprops.xml 
eb_deathstar_port.alo	Spaceprops.xml 
w_lightning.alo	Spaceprops.xml 
w_asteroid_mass.alo	Spaceprops.xml 
w_asteroid_mass_small.alo	Spaceprops.xml 
w_asteroid_mass_med.alo	Spaceprops.xml 
w_asteroid_mass_blank.alo	Spaceprops.xml 
w_asteroid_mass_med_blank.alo	Spaceprops.xml 
w_nebula03.alo	Spaceprops.xml 
w_nebula00.alo	Spaceprops.xml 
w_nebula01.alo	Spaceprops.xml 
w_nebula02.alo	Spaceprops.xml 
w_nebula04.alo	Spaceprops.xml 
w_nebula03_ion.alo	Spaceprops.xml 
w_nebula00_ion.alo	Spaceprops.xml 
w_nebula01_ion.alo	Spaceprops.xml 
w_nebula02_ion.alo	Spaceprops.xml 
w_nebula04_ion.alo	Spaceprops.xml 
w_black_hole.alo	Spaceprops.xml 
w_spacejunk.alo	Spaceprops.xml 
w_spacejunk_med.alo	Spaceprops.xml 
w_spacejunk_sml.alo	Spaceprops.xml 
rv_moncalcruiser_hulk.alo	Spaceprops.xml 
rv_nebulonb_hp00_f-l.alo	Spaceprops.xml 
rv_nebulonb_hp00_f-r.alo	Spaceprops.xml 
rv_nebulonb_hp00_b-l.alo	Spaceprops.xml 
rv_nebulonb_hp00_b-r.alo	Spaceprops.xml 
ev_victorystardestroyer_hp00_c-f.alo	Spaceprops.xml 
ev_victorystardestroyer_hp00_m-r.alo	Spaceprops.xml 
ev_victorystardestroyer_hp00_m-l.alo	Spaceprops.xml 
ev_victorystardestroyer_hp00_c-b.alo	Spaceprops.xml 
ev_acclamator_hp00_f-l.alo	Spaceprops.xml 
ev_acclamator_hp00_f-r.alo	Spaceprops.xml 
ev_acclamator_hp00_f-c.alo	Spaceprops.xml 
ev_acclamator_hp00_b-l.alo	Spaceprops.xml 
ev_acclamator_hp00_b-r.alo	Spaceprops.xml 
nv_jedicruiser_hp_b-m.alo	Spaceprops.xml 
nv_jedicruiser_hp_f-r.alo	Spaceprops.xml 
nv_jedicruiser_hp_f-l.alo	Spaceprops.xml 
nb_apbase_hp_ll2.alo	Spaceprops.xml 
mov_rebel_intro.alo	Spaceprops.xml 
w_stars_nebula_b6.alo	SpaceSecondarySkydomes.xml 
w_stars_nebula_b5.alo	SpaceSecondarySkydomes.xml 
w_stars_nebula_b4.alo	SpaceSecondarySkydomes.xml 
w_stars_nebula_b3.alo	SpaceSecondarySkydomes.xml 
w_stars_nebula_b2.alo	SpaceSecondarySkydomes.xml 
w_stars_nebula_a9.alo	SpaceSecondarySkydomes.xml 
w_stars_nebula_a8.alo	SpaceSecondarySkydomes.xml 
w_stars_nebula_a4.alo	SpaceSecondarySkydomes.xml 
w_stars_nebula_rotm1.alo	SpaceSecondarySkydomes.xml 
w_stars_nebula_rotm2.alo	SpaceSecondarySkydomes.xml 
w_stars_nebula_rotm3.alo	SpaceSecondarySkydomes.xml 
w_stars_nebula_rotm4.alo	SpaceSecondarySkydomes.xml 
w_stars_nebula_one.alo	SpaceSecondarySkydomes.xml 
w_stars_nebula_two.alo	SpaceSecondarySkydomes.xml 
w_stars_nebula_three.alo	SpaceSecondarySkydomes.xml 
w_stars_nebula_four.alo	SpaceSecondarySkydomes.xml 
w_stars_nebula_five.alo	SpaceSecondarySkydomes.xml 
w_stars_nebula_six.alo	SpaceSecondarySkydomes.xml 
w_stars_nebula_seven.alo	SpaceSecondarySkydomes.xml 
w_stars_nebula_eight.alo	SpaceSecondarySkydomes.xml 
w_stars_nebula_nine.alo	SpaceSecondarySkydomes.xml 
w_stars_nebula_ten.alo	SpaceSecondarySkydomes.xml 
w_stars_nebula_eleven.alo	SpaceSecondarySkydomes.xml 
w_stars_nebula_twelve.alo	SpaceSecondarySkydomes.xml 
w_stars_nebula_spire_two.alo	SpaceSecondarySkydomes.xml 
w_stars_nebula_spire.alo	SpaceSecondarySkydomes.xml 
w_stars_nebula_fire_two.alo	SpaceSecondarySkydomes.xml 
w_stars_nebula_fire.alo	SpaceSecondarySkydomes.xml 
w_stars_nebula_orion.alo	SpaceSecondarySkydomes.xml 
w_stars_nebula_orion_blue.alo	SpaceSecondarySkydomes.xml 
w_stars_nebula_orion_pink.alo	SpaceSecondarySkydomes.xml 
w_stars_nebula_blue.alo	SpaceSecondarySkydomes.xml 
w_stars_nebula_core_purple.alo	SpaceSecondarySkydomes.xml 
w_stars_nebula_core_brown.alo	SpaceSecondarySkydomes.xml 
w_stars_nebula_core_tan.alo	SpaceSecondarySkydomes.xml 
w_stars_nebula_core_green.alo	SpaceSecondarySkydomes.xml 
w_stars_nebula_core_blueish_red.alo	SpaceSecondarySkydomes.xml 
w_stars_nebula_steel_blue.alo	SpaceSecondarySkydomes.xml 
w_stars_nebula_green.alo	SpaceSecondarySkydomes.xml 
w_stars_nebula_green_orange.alo	SpaceSecondarySkydomes.xml 
w_stars_nebula_green_orange02.alo	SpaceSecondarySkydomes.xml 
w_stars_nebula_orange.alo	SpaceSecondarySkydomes.xml 
w_stars_nebula_orange02.alo	SpaceSecondarySkydomes.xml 
w_stars_nebula_purple.alo	SpaceSecondarySkydomes.xml 
w_stars_nebula_purple02.alo	SpaceSecondarySkydomes.xml 
w_stars_nebula_red.alo	SpaceSecondarySkydomes.xml 
w_stars_nebula_red_light.alo	SpaceSecondarySkydomes.xml 
w_stars_nebula_red_vivid.alo	SpaceSecondarySkydomes.xml 
w_stars_nebula_15.alo	SpaceSecondarySkydomes.xml 
w_stars_nebula_16.alo	SpaceSecondarySkydomes.xml 
w_stars_nebula_17.alo	SpaceSecondarySkydomes.xml 
w_stars_nebula_18.alo	SpaceSecondarySkydomes.xml 
w_stars_nebula_19.alo	SpaceSecondarySkydomes.xml 
w_stars_nebula_20.alo	SpaceSecondarySkydomes.xml 
w_stars_nebula_21.alo	SpaceSecondarySkydomes.xml 
w_stars_nebula_22.alo	SpaceSecondarySkydomes.xml 
w_stars_nebula_23.alo	SpaceSecondarySkydomes.xml 
w_stars_nebula_24.alo	SpaceSecondarySkydomes.xml 
w_stars_nebula_25.alo	SpaceSecondarySkydomes.xml 
w_stars_nebula_26.alo	SpaceSecondarySkydomes.xml 
w_stars_nebula_27.alo	SpaceSecondarySkydomes.xml 
w_stars_nebula_28.alo	SpaceSecondarySkydomes.xml 
w_stars_nebula_29.alo	SpaceSecondarySkydomes.xml 
w_stars_nebula_30.alo	SpaceSecondarySkydomes.xml 
w_stars_nebula_31.alo	SpaceSecondarySkydomes.xml 
w_stars_nebula_32.alo	SpaceSecondarySkydomes.xml 
w_stars_nebula_33.alo	SpaceSecondarySkydomes.xml 
w_stars_nebula_34.alo	SpaceSecondarySkydomes.xml 
w_stars_nebula_35.alo	SpaceSecondarySkydomes.xml 
w_stars_nebula_36.alo	SpaceSecondarySkydomes.xml 
w_stars_nebula_37.alo	SpaceSecondarySkydomes.xml 
w_stars_nebula_38.alo	SpaceSecondarySkydomes.xml 
w_stars_nebula_39.alo	SpaceSecondarySkydomes.xml 
w_stars_nebula_40.alo	SpaceSecondarySkydomes.xml 
w_stars_nebula_41.alo	SpaceSecondarySkydomes.xml 
w_stars_nebula_42.alo	SpaceSecondarySkydomes.xml 
w_stars_nebula_43.alo	SpaceSecondarySkydomes.xml 
w_stars_nebula_44.alo	SpaceSecondarySkydomes.xml 
w_stars_nebula_45.alo	SpaceSecondarySkydomes.xml 
w_stars_nebula_46.alo	SpaceSecondarySkydomes.xml 
w_stars_nebula_47.alo	SpaceSecondarySkydomes.xml 
w_stars_nebula_48.alo	SpaceSecondarySkydomes.xml 
w_stars_nebula_49.alo	SpaceSecondarySkydomes.xml 
w_stars_nebula_50.alo	SpaceSecondarySkydomes.xml 
w_stars_nebula_51.alo	SpaceSecondarySkydomes.xml 
w_stars_nebula_52.alo	SpaceSecondarySkydomes.xml 
w_stars_nebula_53.alo	SpaceSecondarySkydomes.xml 
w_stars_nebula_54.alo	SpaceSecondarySkydomes.xml 
w_stars_nebula_55.alo	SpaceSecondarySkydomes.xml 
w_stars_nebula_56.alo	SpaceSecondarySkydomes.xml 
w_stars_nebula_57.alo	SpaceSecondarySkydomes.xml 
w_stars_nebula_58.alo	SpaceSecondarySkydomes.xml 
w_stars_nebula_59.alo	SpaceSecondarySkydomes.xml 
w_stars_nebula_60.alo	SpaceSecondarySkydomes.xml 
w_stars_nebula_61.alo	SpaceSecondarySkydomes.xml 
w_stars_nebula_62.alo	SpaceSecondarySkydomes.xml 
w_stars_nebula_63.alo	SpaceSecondarySkydomes.xml 
w_stars_nebula_64.alo	SpaceSecondarySkydomes.xml 
w_stars_nebula_65.alo	SpaceSecondarySkydomes.xml 
w_stars_nebula_66.alo	SpaceSecondarySkydomes.xml 
w_stars_nebula_67.alo	SpaceSecondarySkydomes.xml 
w_stars_nebula_68.alo	SpaceSecondarySkydomes.xml 
w_stars_nebula_69.alo	SpaceSecondarySkydomes.xml 
nv_ipv1.alo	Spaceunitscorvettes.xml Uniqueunits.xml 
ev_missile_ship.alo	Spaceunitscorvettes.xml 
ev_missile_ship_d.alo	Spaceunitscorvettes.xml 
nv_shadowclaw.alo	Spaceunitscorvettes.xml 
nv_shadowclaw_d.alo	Spaceunitscorvettes.xml 
t-65_x-wing_starfighter.alo	Spaceunitsfighters.xml Squadrons.xml 
btl_y-wing.alo	Spaceunitsfighters.xml Squadrons.xml 
ev_tiescout.alo	Spaceunitsfighters.xml Squadrons.xml 
z-95_headhunter.alo	Spaceunitsfighters.xml Units_hero_rebel_squadrons.xml 
nv_black_sun_fighter.alo	Spaceunitsfighters.xml 
nv_pirate_frigate.alo	Spaceunitsfrigates.xml 
nv_pirate_frigate_d.alo	Spaceunitsfrigates.xml 
w_planet_deathstar02.alo	Spaceunitssupers.xml 
w_planet_fleet_ds.alo	Spaceunitssupers.xml 
w_cantinatat.alo	Specialstructures.xml 
rb_barracks.alo	Specialstructures.xml 
nv_defensesatellite.alo	Specialstructures.xml 
ub_gravcontrolgen.alo	Specialstructures_underworld.xml 
i_rb_station_level1.alo	Starbases.xml 
rb_station_01_break.alo	Starbases.xml 
rb_station_02.alo	Starbases.xml 
i_rb_station_level2.alo	Starbases.xml 
rb_station_02_break.alo	Starbases.xml 
rb_station_03.alo	Starbases.xml 
i_rb_station_level3.alo	Starbases.xml 
rb_station_03_break.alo	Starbases.xml 
rb_station_04.alo	Starbases.xml 
i_rb_station_level4.alo	Starbases.xml 
rb_station_04_break.alo	Starbases.xml 
i_rb_station_level5.alo	Starbases.xml 
rb_station_05_break.alo	Starbases.xml 
i_eb_station_level1.alo	Starbases.xml 
eb_station_break_break_01.alo	Starbases.xml 
eb_station_02.alo	Starbases.xml 
i_eb_station_level2.alo	Starbases.xml 
eb_station_break_break_02.alo	Starbases.xml 
eb_station_03.alo	Starbases.xml 
i_eb_station_level3.alo	Starbases.xml 
eb_station_break_break_03.alo	Starbases.xml 
eb_station_04.alo	Starbases.xml 
i_eb_station_level4.alo	Starbases.xml 
eb_station_break_break_04.alo	Starbases.xml 
eb_station_break_break_05.alo	Starbases.xml 
nb_apbase.alo	Starbases.xml 
i_pirate_station.alo	Starbases.xml 
ub_01_station.alo	Starbases_underworld.xml 
i_ub_01_station.alo	Starbases_underworld.xml 
ub_01_station_d.alo	Starbases_underworld.xml 
ub_02_station.alo	Starbases_underworld.xml 
i_ub_02_station.alo	Starbases_underworld.xml 
ub_02_station_d.alo	Starbases_underworld.xml 
ub_03_station.alo	Starbases_underworld.xml 
i_ub_03_station.alo	Starbases_underworld.xml 
ub_03_station_d.alo	Starbases_underworld.xml 
ub_04_station.alo	Starbases_underworld.xml 
i_ub_04_station.alo	Starbases_underworld.xml 
ub_04_station_d.alo	Starbases_underworld.xml 
ub_05_station.alo	Starbases_underworld.xml 
i_ub_05_station.alo	Starbases_underworld.xml 
ub_05_station_d.alo	Starbases_underworld.xml 
w_textscroll.alo	Starwars3dtextcrawl.xml 
w_textintro.alo	Starwars3dtextcrawl.xml 
ev_sentinel.alo	Transportunits.xml 
ev_sentinel_space.alo	Transportunits.xml 
ev_imperialcraft_space_d.alo	Transportunits.xml 
ev_at-barge_land.alo	Transportunits.xml 
ev_at-barge_d.alo	Transportunits.xml 
rv_transport_d.alo	Transportunits.xml 
ev_lambdashuttle.alo	Transportunits.xml 
ev_lambdashuttle_space_d.alo	Transportunits.xml Units_hero_rebel_lando_calrissian.xml 
rv_herotransport.alo	Transportunits.xml 
rv_herotransport_d.alo	Transportunits.xml 
w_flag_pod_empire.alo	UGC_CE_Objects.xml 
w_flag_pod_empire_standalone.alo	UGC_CE_Objects.xml 
ugc_ce_prop_tatooine_01.alo	UGC_CE_Objects.xml 
ugc_ce_prop_tatooine_01_ald.alo	UGC_CE_Objects.xml 
ugc_ce_prop_tatooine_01_copper.alo	UGC_CE_Objects.xml 
ugc_ce_prop_tatooine_02.alo	UGC_CE_Objects.xml 
ugc_ce_prop_tatooine_03.alo	UGC_CE_Objects.xml 
ugc_ce_prop_tatooine_04.alo	UGC_CE_Objects.xml 
ugc_ce_prop_tatooine_05.alo	UGC_CE_Objects.xml 
ugc_ce_prop_tatooine_06.alo	UGC_CE_Objects.xml 
ugc_ce_prop_tatooine_07.alo	UGC_CE_Objects.xml 
ugc_ce_prop_tatooine_07a.alo	UGC_CE_Objects.xml 
ugc_ce_prop_tatooine_astroport_a.alo	UGC_CE_Objects.xml 
prop_urban_astroport_a.alo	UGC_CE_Objects.xml 
w_theed_1.alo	UGC_CE_Objects.xml 
w_theed_1b.alo	UGC_CE_Objects.xml 
w_theed_2.alo	UGC_CE_Objects.xml 
w_theed_2a.alo	UGC_CE_Objects.xml 
w_theed_2b.alo	UGC_CE_Objects.xml 
w_theed_2c.alo	UGC_CE_Objects.xml 
w_theed_3.alo	UGC_CE_Objects.xml 
w_theed_4.alo	UGC_CE_Objects.xml 
w_theed_4a.alo	UGC_CE_Objects.xml 
w_theed_4b.alo	UGC_CE_Objects.xml 
w_theed_4c.alo	UGC_CE_Objects.xml 
w_theed_5.alo	UGC_CE_Objects.xml 
w_theed_6.alo	UGC_CE_Objects.xml 
w_theed_7.alo	UGC_CE_Objects.xml 
w_theed_8.alo	UGC_CE_Objects.xml 
w_theed_9.alo	UGC_CE_Objects.xml 
w_theed_10.alo	UGC_CE_Objects.xml 
w_theed_11.alo	UGC_CE_Objects.xml 
w_theed_12.alo	UGC_CE_Objects.xml 
w_theed_statue.alo	UGC_CE_Objects.xml 
w_rhn_bridge.alo	UGC_CE_Objects.xml 
w_rhn_building.alo	UGC_CE_Objects.xml 
w_rhn_citadel_tower_01.alo	UGC_CE_Objects.xml 
w_rhn_citadel_tower_02.alo	UGC_CE_Objects.xml 
w_rhn_common.alo	UGC_CE_Objects.xml 
w_rhn_common_02.alo	UGC_CE_Objects.xml 
w_rhn_lighthouse.alo	UGC_CE_Objects.xml 
w_rhn_observatory.alo	UGC_CE_Objects.xml 
w_rhn_overlook.alo	UGC_CE_Objects.xml 
w_rhn_rotunda.alo	UGC_CE_Objects.xml 
w_rhn_tower.alo	UGC_CE_Objects.xml 
w_rhn_vista.alo	UGC_CE_Objects.xml 
w_rhn_obelisk.alo	UGC_CE_Objects.xml 
w_rhn_gargoyle.alo	UGC_CE_Objects.xml 
w_rhn_statue.alo	UGC_CE_Objects.xml 
w_rhn_statue_cracked.alo	UGC_CE_Objects.xml 
w_rhn_statue_snowy.alo	UGC_CE_Objects.xml 
rv_xwing.alo	Uniqueunits.xml 
ev_tieadvanced.alo	Uniqueunits.xml 
rv_mfalcon_backwards.alo	Uniqueunits.xml 
rv_mfalcon_backwards_d.alo	Uniqueunits.xml 
nv_vwing.alo	Uniqueunits.xml Units_hero_empire_shea_hublin.xml Units_space_empire_alpha_3.xml 
nv_jedicruiser_d.alo	Uniqueunits.xml 
nv_swampspeeder.alo	Uniqueunits.xml 
nv_swampspeeder_e.alo	Uniqueunits.xml 
nv_swampspeeder_r.alo	Uniqueunits.xml Units_land_rebel_isp.xml 
nv_swampspeeder_p.alo	Uniqueunits.xml 
nv_swampspeeder_chew.alo	Uniqueunits.xml 
ev_podwalker.alo	Uniqueunits.xml 
nv_virago.alo	Uniqueunits.xml 
ev_slave1.alo	Units_bh_empire_boba_fett.xml 
ev_slave1_space.alo	Units_bh_empire_boba_fett.xml 
ev_slave1_space_d.alo	Units_bh_empire_boba_fett.xml 
ui_bossk.alo	Units_bh_empire_bossk.xml 
uv_houndstooth_landing.alo	Units_bh_empire_bossk.xml 
uv_houndstooth.alo	Units_bh_empire_bossk.xml 
uv_houndstooth_d.alo	Units_bh_empire_bossk.xml 
ui_ig88.alo	Units_bh_empire_ig88.xml 
uv_ig2000_landing.alo	Units_bh_empire_ig88.xml 
uv_ig2000.alo	Units_bh_empire_ig88.xml 
uv_ig2000_d.alo	Units_bh_empire_ig88.xml 
181_st_interceptor.alo	Units_hero_empire_181st.xml 
181_st_defender.alo	Units_hero_empire_181st.xml 
imperial_ii-class_star_destroyer_black.alo	Units_hero_empire_blackhole.xml 
ei_brakiss.alo	Units_hero_empire_brakiss.xml Units_hero_rebel_kyp_durron.xml 
ei_armygeneral.alo	Units_hero_empire_cassio_tagge.xml Units_hero_empire_danetta_pitta.xml Units_hero_empire_hestiv.xml Units_hero_empire_hurst_romodi.xml Units_hero_empire_immodet.xml Units_hero_empire_malcor_brashin.xml Units_hero_empire_redd_wessel.xml Units_hero_empire_sutt_ramic.xml Units_hero_empire_trachta.xml Units_land_empire_troopers.xml 
ei_fieldcomandere11.alo	Units_hero_empire_cassio_tagge.xml Units_hero_empire_danetta_pitta.xml Units_hero_empire_hestiv.xml Units_hero_empire_hurst_romodi.xml Units_hero_empire_immodet.xml Units_hero_empire_malcor_brashin.xml Units_hero_empire_redd_wessel.xml Units_hero_empire_sutt_ramic.xml Units_hero_empire_trachta.xml Units_land_empire_troopers.xml 
ei_armytrooper.alo	Units_hero_empire_cassio_tagge.xml Units_hero_empire_danetta_pitta.xml Units_hero_empire_hestiv.xml Units_hero_empire_hurst_romodi.xml Units_hero_empire_rom_mohc.xml Units_hero_empire_sutt_ramic.xml Units_land_empire_troopers.xml 
ei_trooper_sgt.alo	Units_hero_empire_malcor_brashin.xml Units_hero_empire_trachta.xml Units_hero_empire_vader.xml 
ev_knight_hammer.alo	Units_hero_empire_natasi_daala.xml 
modular_taskforce_cruiser.alo	Units_hero_empire_rom_mohc.xml 
ev_archammer.alo	Units_hero_empire_rom_mohc.xml 
ev_archammer_d.alo	Units_hero_empire_rom_mohc.xml 
ev_13x.alo	Units_hero_empire_treuten_teradoc.xml 
ei_vader.alo	Units_hero_empire_vader.xml 
ei_trooper_lt.alo	Units_hero_empire_vader.xml 
ffh_rv_kdy_endurance.alo	Units_hero_rebel_areta_bell.xml Units_space_rebel_NebulaSD.xml 
ri_newrinfantry_urban.alo	Units_hero_rebel_brenn_tantor.xml Units_hero_rebel_kapp_dendo.xml Units_land_rebel_troopers.xml 
ri_newrinfantry_forest.alo	Units_hero_rebel_brenn_tantor.xml Units_hero_rebel_kapp_dendo.xml Units_land_rebel_troopers.xml 
ri_newrinfantry_snow.alo	Units_hero_rebel_brenn_tantor.xml Units_hero_rebel_kapp_dendo.xml Units_land_rebel_troopers.xml 
ri_newrinfantry_desert.alo	Units_hero_rebel_brenn_tantor.xml Units_hero_rebel_kapp_dendo.xml Units_land_rebel_troopers.xml 
ri_corran_horn.alo	Units_hero_rebel_corran_horn.xml 
rv_xwing_landing.alo	Units_hero_rebel_corran_horn.xml 
rv_gargantuan.alo	Units_hero_rebel_garm_bel_iblis.xml 
rv_gargantuan_dc.alo	Units_hero_rebel_garm_bel_iblis.xml 
f_mc85.alo	Units_hero_rebel_gial_ackbar.xml 
f_mc85_d.alo	Units_hero_rebel_gial_ackbar.xml 
ri_hansolo.alo	Units_hero_rebel_han_solo.xml 
ri_chewbacca.alo	Units_hero_rebel_han_solo.xml 
yt-1300_light_freighter.alo	Units_hero_rebel_han_solo.xml 
rv_mfalcon_d.alo	Units_hero_rebel_han_solo.xml 
ri_skywalker.alo	Units_hero_rebel_kam_solusar.xml Units_hero_rebel_lukeskywalker.xml 
ri_kyle_jedi.alo	Units_hero_rebel_kyle_katarn.xml 
nv_moldycrow_landing.alo	Units_hero_rebel_kyle_katarn.xml 
nv_moldycrow.alo	Units_hero_rebel_kyle_katarn.xml 
lambda-class_t-4_shuttle.alo	Units_hero_rebel_lando_calrissian.xml 
ri_kota.alo	Units_hero_rebel_rahm_kota.xml 
venator-class_star_destroyer_republic.alo	Units_hero_rebel_rahm_kota.xml 
rv_salvation.alo	Units_hero_rebel_rahm_kota.xml 
nv_vwing_republic.alo	Units_hero_rebel_rahm_kota.xml 
arc-170_starfighter_republic.alo	Units_hero_rebel_rahm_kota.xml 
rv_antilliesvette.alo	Units_hero_rebel_raymus_antilles.xml 
rv_antilliesvette_d.alo	Units_hero_rebel_raymus_antilles.xml 
rv_wildkarrde.alo	Units_hero_rebel_talon_karrde.xml 
rv_wildkarrde_die.alo	Units_hero_rebel_talon_karrde.xml 
rv_lusankya.alo	Units_hero_rebel_wedge_antilles.xml 
sv_armored_assault_tank.alo	Units_land_cis_aat.xml 
cis_aat.alo	Units_land_cis_aat.xml 
ev_at_aa.alo	Units_land_empire_AT-AA.xml 
ev_at_dp.alo	Units_land_empire_AT_AR.xml 
century_tank.alo	Units_land_empire_century_tank.xml 
ei_darktrooper_one.alo	Units_land_empire_darktroopers.xml 
ei_darktrooper_two.alo	Units_land_empire_darktroopers.xml 
ei_darktroop_three.alo	Units_land_empire_darktroopers.xml 
ei_darktrooperatat.alo	Units_land_empire_darktroopers.xml 
ei_imperial_army_e-web_crew.alo	Units_land_empire_e_web_crew.xml 
ei_imperial_army_e-web15_crew.alo	Units_land_empire_e_web_crew.xml 
ev_a9_floating_fortress.alo	Units_land_empire_floating_fortress.xml 
ev_ja5.alo	Units_land_empire_juggernaut.xml 
ev_laat.alo	Units_land_empire_laat.xml 
ev_tie_lancet.alo	Units_land_empire_lancet.xml 
ev_maat.alo	Units_land_empire_maat.xml 
ev_mobile_artillery.alo	Units_land_empire_mobile_artillery.xml 
ni_noghri.alo	Units_land_empire_noghri.xml 
px-10_compact_assault_vehicle.alo	Units_land_empire_px_10.xml 
qh-7_chariot_light_assault_vehicle.alo	Units_land_empire_qh_7_chariot.xml 
ev_s1_firehawke.alo	Units_land_empire_s1_firehawke.xml 
ei_army_trooper_e11.alo	Units_land_empire_troopers.xml 
ei_army_sergeant_e11.alo	Units_land_empire_troopers.xml 
ei_army_lieutenant_e11.alo	Units_land_empire_troopers.xml 
ei_army_trooper_e15.alo	Units_land_empire_troopers.xml 
ei_army_sergeant_e15.alo	Units_land_empire_troopers.xml 
ei_army_lieutenant_e15.alo	Units_land_empire_troopers.xml 
ei_armylieutenant.alo	Units_land_empire_troopers.xml 
rv_aac_hovertank.alo	Units_land_rebel_aac.xml 
arrow-23_landspeeder.alo	Units_land_rebel_arrow_23_landspeeder.xml 
a-a5_speeder_truck.alo	Units_land_rebel_a_a5_speeder_truck.xml 
armored_freerunner.alo	Units_land_rebel_freerunner.xml 
rv_gallofreehtt26.alo	Units_land_rebel_gallofree_htt.xml 
heavy_tracker.alo	Units_land_rebel_heavy_tracker.xml 
ri_antitrooper_dc15a.alo	Units_land_rebel_minor_troopers.xml 
rv_mptl-2a.alo	Units_land_rebel_mptl.xml 
rv_mptl-2aspotter.alo	Units_land_rebel_mptl.xml 
rv_t-1b.alo	Units_land_rebel_t1b.xml 
rv_t2_b.alo	Units_land_rebel_t2b.xml 
rv_t3-b.alo	Units_land_rebel_t3b.xml 
rv_snowspeeder.alo	Units_land_rebel_t47.xml Units_land_rebel_v_wing_speeder.xml 
rv_t4_b.alo	Units_land_rebel_t4b.xml 
ri_newrinfantryplex_urban.alo	Units_land_rebel_troopers.xml 
ri_newrinfantryplex_forest.alo	Units_land_rebel_troopers.xml 
ri_newrinfantryplex_snow.alo	Units_land_rebel_troopers.xml 
ri_vanguard_urban.alo	Units_land_rebel_troopers.xml 
ri_vanguard_snow.alo	Units_land_rebel_troopers.xml 
ri_vanguard_desert.alo	Units_land_rebel_troopers.xml 
ri_vanguard_jungle.alo	Units_land_rebel_troopers.xml 
rv_ulav.alo	Units_land_rebel_ulav.xml 
rv_vwing.alo	Units_land_rebel_v_wing_speeder.xml 
diamoncruiser.alo	Units_space_cis_diamond.xml 
sev_droid_bomber.alo	Units_space_cis_droidbomber.xml 
cv_lucrehulk.alo	Units_space_cis_lucrehulk.xml 
cv_lucrehulk_dcs.alo	Units_space_cis_lucrehulk.xml 
cv_munificent.alo	Units_space_cis_munificent.xml 
cv_providence.alo	Units_space_cis_providence.xml 
cv_recusant.alo	Units_space_cis_recusant.xml Units_space_rebel_recusant.xml 
sev_carrier.alo	Units_space_cis_tf_carrier.xml 
sev_tridroid.alo	Units_space_cis_tridroid.xml 
sev_vulture.alo	Units_space_cis_vulture.xml 
rev_acclamator1.alo	Units_space_empire_acclamator.xml 
rev_acclamator1_d.alo	Units_space_empire_acclamator.xml 
f_allegiance.alo	Units_space_empire_allegiance.xml 
f_allegiance_d.alo	Units_space_empire_allegiance.xml 
arc-170_starfighter.alo	Units_space_empire_arc_170.xml 
f_gunboat.alo	Units_space_empire_Assault_Gunboat.xml 
f_carrack.alo	Units_space_empire_carrack.xml 
f_carrack_d.alo	Units_space_empire_carrack.xml 
super_transport_viii_escort_carrier.alo	Units_space_empire_escort_carrier.xml 
ev_executor_star_dreadnaught.alo	Units_space_empire_executor.xml 
ev_executorstardestroyer_d.alo	Units_space_empire_executor.xml 
ev_demolisher.alo	Units_space_empire_gladiator.xml 
ev_demolisher_d.alo	Units_space_empire_gladiator.xml 
ev_interdictor.alo	Units_space_empire_immobilizer_418.xml Units_space_empire_vindicator.xml 
ev_interdictor_d.alo	Units_space_empire_immobilizer_418.xml 
imperial_i-class_star_destroyer.alo	Units_space_empire_isd.xml 
imperial_ii-class_star_destroyer.alo	Units_space_empire_isd.xml 
tector_i-class_star_destroyer.alo	Units_space_empire_isd.xml 
dominator_i-class_star_destroyer.alo	Units_space_empire_isd.xml 
dominator_iii-class_star_destroyer.alo	Units_space_empire_isd.xml 
f_lancer.alo	Units_space_empire_lancer_frigate.xml 
f_lancer_d.alo	Units_space_empire_lancer_frigate.xml 
f_missile_gunboat.alo	Units_space_empire_Missile_Boat.xml 
f_nebulonb2.alo	Units_space_empire_nebulon_b2.xml 
f_nebulonb.alo	Units_space_empire_nebulon_b2.xml Units_space_rebel_nebulon_b.xml 
f_nebulonb2_d.alo	Units_space_empire_nebulon_b2.xml 
ev_praetor_mkii.alo	Units_space_empire_praetor_mkii.xml 
ev_praetor_ii_d.alo	Units_space_empire_praetor_mkii.xml 
sovereign-class_star_dreadnought.alo	Units_space_empire_Sovereign.xml 
f_loronar.alo	Units_space_empire_strike.xml 
f_loronar_d.alo	Units_space_empire_strike.xml 
ev_tieavenger.alo	Units_space_empire_tie_avenger.xml 
ev_tie_defender.alo	Units_space_empire_tie_defender.xml 
ev_tiehunter.alo	Units_space_empire_tie_hunter.xml 
ev_tie_interceptor.alo	Units_space_empire_tie_interceptor.xml 
ev_tie_phantom.alo	Units_space_empire_tie_phantom.xml 
ev_tie_starhunter.alo	Units_space_empire_tie_starhunter.xml 
ev_turbulent.alo	Units_space_empire_Turbulent.xml 
venator-class_star_destroyer.alo	Units_space_empire_venator.xml 
enforcership.alo	Units_space_empire_vindicator.xml 
enforcership_d.alo	Units_space_empire_vindicator.xml 
ev_victory1.alo	Units_space_empire_vsd.xml 
ev_victory1_death.alo	Units_space_empire_vsd.xml 
ev_victory2.alo	Units_space_empire_vsd2.xml 
ev_victory2_death.alo	Units_space_empire_vsd2.xml 
ev_victory_lp.alo	Units_space_empire_vsd_lp.xml 
r-22_a-wing.alo	Units_space_rebel_a-wing.xml 
rz-1_a-wing.alo	Units_space_rebel_a-wing.xml 
f_assault.alo	Units_space_rebel_AAF.xml 
f_assault_d.alo	Units_space_rebel_AAF.xml 
rv_assaultfrigate.alo	Units_space_rebel_AAF2.xml 
rv_assaultfrigate_d.alo	Units_space_rebel_AAF2.xml 
b-wing.alo	Units_space_rebel_b-wing.xml 
f_bothan.alo	Units_space_rebel_bothan_assault_cruiser.xml 
f_bothan_d.alo	Units_space_rebel_bothan_assault_cruiser.xml 
cv_bulwark_mk1_rebel.alo	Units_space_rebel_bulwark.xml 
cv_bulwark_mk1_rebel_d.alo	Units_space_rebel_bulwark.xml 
cc-7700_frigate.alo	Units_space_rebel_CC-7700.xml 
cc-7700efrigate.alo	Units_space_rebel_CC-7700.xml 
rep_corvette_03.alo	Units_space_rebel_consular.xml 
rv_corvette.alo	Units_space_rebel_cr90.xml 
rv_corvette_d.alo	Units_space_rebel_cr90.xml 
f_dauntless.alo	Units_space_rebel_dauntless.xml 
f_dauntless_d.alo	Units_space_rebel_dauntless.xml 
f_corellian_gunship.alo	Units_space_rebel_dp20.xml 
f_corellian_gunship_d.alo	Units_space_rebel_dp20.xml 
f_dreadnought.alo	Units_space_rebel_dreadnought.xml 
f_dreadnought_d.alo	Units_space_rebel_dreadnought.xml 
e-wing.alo	Units_space_rebel_e-wing.xml 
f_e-wing.alo	Units_space_rebel_e-wing.xml 
galaxy_destroyer.alo	Units_space_rebel_GalacticBC.xml 
galaxy_destroyer_d.alo	Units_space_rebel_GalacticBC.xml 
f_independence.alo	Units_space_rebel_home_one_type_mc80.xml 
f_independence_d.alo	Units_space_rebel_home_one_type_mc80.xml 
btl_k-wing.alo	Units_space_rebel_k-wing.xml 
rv_kwing.alo	Units_space_rebel_k-wing.xml 
f_liberator.alo	Units_space_rebel_liberator.xml 
f_liberator_d.alo	Units_space_rebel_liberator.xml 
f_majestic.alo	Units_space_rebel_majestic.xml 
f_majestic_d.alo	Units_space_rebel_majestic.xml 
marauder-class_corvette.alo	Units_space_rebel_marauder.xml 
rv_missile_ship_d.alo	Units_space_rebel_marauder.xml 
rv_missile_ship.alo	Units_space_rebel_marauder.xml 
rv_mc30cmoncal.alo	Units_space_rebel_mc30_frigate.xml 
rv_mc30cmoncal_d.alo	Units_space_rebel_mc30_frigate.xml 
f_mc40b.alo	Units_space_rebel_mc40_frigate.xml 
f_mc40b_d.alo	Units_space_rebel_mc40_frigate.xml 
f_mc80b.alo	Units_space_rebel_mc80.xml 
f_mc80b_d.alo	Units_space_rebel_mc80.xml 
reef_home-class_mc80_star_cruiser.alo	Units_space_rebel_mc80a.xml 
f_mc80c.alo	Units_space_rebel_mc80b.xml 
f_mc80c_d.alo	Units_space_rebel_mc80b.xml 
f_mc90.alo	Units_space_rebel_mc90.xml 
f_mc90b.alo	Units_space_rebel_mc90.xml 
f_mc90_d.alo	Units_space_rebel_mc90.xml 
rv_mediator_battlecruiser.alo	Units_space_rebel_mediator.xml 
rv_mediator_cruiser_d.alo	Units_space_rebel_mediator.xml 
blue_diver.alo	Units_space_rebel_MonCalHC.xml 
blue_diver_d.alo	Units_space_rebel_MonCalHC.xml 
cv_munificent_rebel.alo	Units_space_rebel_munificent.xml 
ffh_rv_new_nebula_defendersd.alo	Units_space_rebel_NebulaSD.xml 
f_nebulonb_d.alo	Units_space_rebel_nebulon_b.xml 
rv_ranger.alo	Units_space_rebel_ranger.xml 
rv_ranger_d.alo	Units_space_rebel_ranger.xml 
cv_recusant_rebel.alo	Units_space_rebel_recusant.xml 
rep_corvette_05.alo	Units_space_rebel_rep_assault_cruiser.xml 
r-41_starchaser.alo	Units_space_rebel_R_41.xml 
f_sacheen.alo	Units_space_rebel_sacheen.xml 
f_sacheen_d.alo	Units_space_rebel_sacheen.xml 
strident.alo	Units_space_rebel_Strident.xml 
strident_d.alo	Units_space_rebel_Strident.xml 
rv_viscount_class_star_defender.alo	Units_space_rebel_viscount.xml 
viscount_d.alo	Units_space_rebel_viscount.xml 
f_ferret.alo	Units_space_rebel_warrior_gunship.xml 
